    #####   #####
#####   #####   #####
#   #   #   #   #   #
#  $.$$$.$ $.$$$.$  #
###.#...#...#...#.###
 # $.$ $.$$$.$ $.$ #
 #  .$ $.   .$ $.  #
 # $.$ $.$$$.$ $.$ #
###.#...#...#...#.###
#  $.$$$.$ $.$$$.$  #
#  $.   .$@$.   .$  #
#  $.$$$.$ $.$$$.$  #
###.#...#...#...#.###
 # $.$ $.$$$.$ $.$ #
 #  .$ $.   .$ $.  #
 # $.$ $.$$$.$ $.$ #
###.#...#...#...#.###
#  $.$$$.$ $.$$$.$  #
#   #   #   #   #   #
#####   #####   #####
    #####   #####