  ####### ## #######
  #     ######     ##
  #.###  ##  .  ##  ##
  # .  #  $*# .#  #  #
  # #.  ###.#  *$  # #######
  # $ *    ###  .  #       ##
 ###$# * $$  ##$ .########  #
##  $ # *  #  # # .   #   # #
#  $$  $#. .# @ #. .#$  $$  #
# #   #   . # #  #  * # $  ##
#  ########. $##  $$ * #$###
##       #  .  ###    * $ #
 ####### #  $*  #.###  .# #
       #  #  #. #*$  #  . #
       ##  ##  .  ##  ###.#
        ##     ######     #
         ####### ## #######