 ####
 #  #####
 #  $ $ #
 #* . . #
 #  ########
 #      #  #
 #### $    #
 #   #$### #
 # @$#   # ####
 # $$ $$   #  #
 #   # ## $ * #
## ###.....#. #
#...  ###$# . #
# $ $       . #
########  #####
       ####