             ####
     #########  ###
     #  . .   . . #
     # $$.$# #$.$ #
     ## . .# #. . #
      # $ $#  $ $ #
      # $  #* #####
     ##### # ##
     #   @   #
    ## # #####
##### *#  $ #
# $ $  #$ $ #
# . .# #. . ##
# $.$# #$.$$ #
# . .   . .  #
###  #########
  ####