  ####   ####
  #  # # #  #
###.$#####$.###
# $  .$ $.  $ #
# .  $. .$  . #
###$.## ##.$###
  #.$#   #$.#
 ##    @    ##
  #$.#   #.$#
###.$## ##$.###
# $  .$ $.  $ #
# .  $. .$  . #
###$.#####.$###
  #  # # #  #
  ####   ####