        ####
     ####  #
     #     #
  #### **  #
 ##  #  #  #
 #  *** ####
##$ ..... #
# $ # $ $ #
#   ####$ ##
##### # @  #
      #    #
      ######