  ####
  #  #
  #  ##
###   #
#   # ####
# . @ #  ###
##.# #     #
 #.# #$$$$ #
 #.**$     #
 ###. ##   #
   #  ##  ##
   ########