####  #####
#  ####   #
#     #   #
#      $  #
#  ## #   #
##### ### #
#  ##   #.#
# $   $ #.#
#  ### ##.#
## ###  # #
# $   $ #.#
#   ##  #.#
### #####.#
  #   #@  #
##### ###.#
#  ##   #.#
# $   $ #.#
#  ### ## #
## ###  #.#
# $   $ #.#
#   ##  #.#
### ##### #
###$#   $ #
#         #
# $#  #   #
#     #   #
###########