         ####
   #######  ####
   #         $ ##
####$  ###.###  ##
#   $ #  #.#  #  #
# # $ #   .  @ # #
# #   #..###   # #
# # $#....  #  # #
# #  #...#$  # # #
# #$ # ## $$ $ # #
# #  # .*    ##  #
# #$$## #  ##   ##
# #     ###   ###
#  ####$    ###
##      #####
 ########