          ####
          #  ###
          #    #
   ########$$  #
   #       $  ##
   # #### $$ ##
####....# $  #
#   ...# $$  #
#  #...# $ ###
# @## ## $ #
#         ##
#  #  #####
#######