  #####
 ##  ###
###.   #
#   @$ #
# ** ###
#  ###
# $$ # #
# .. #
## $#####
#    #  ##
# . *#$.##
### * $. #
 ##      #
  ########