        #
       # #
      # . #
     # .$. #
    # .$.$. #
   #  $.$.$  #
  # .$#$.$#$. #
 # .$.$ $ $.$. #
# .$.$.$@$.$.$. #
 # .$.$ $ $.$. #
  # .$#$.$#$. #
   #  $.$.$  #
    # .$.$. #
     # .$. #
      # . #
       # #
        #