 #######
 ##  ###
 # . ###
## *   #
# @**$ #
#    ###
#  #####
####