##### #####
#   ###   #
# #  *  # #
#  *...*$ #
## .$$$. ##
 #* $@$ *#
## .$$$. ##
# $*...*  #
# #  *  # #
#   ###   #
##### #####