     ####
###### @#
#  #  $ #
#  $.#. #
#    #. ###
###$.*.$$ #
  # .#.   #
  ##$  ####
  # $ ##
  #   #
  #####