### #####
# ###  ###
###  *   ##
 #  *$$.  #
## * ..$  #
# *$.@.$* #
#  $.. * ##
#  .$$*  #
##   *  ###
 ###  ### #
  ##### ###