      #####
   #### . ####
   # ##$.$## #
 ####   .   ####
 # ## $$.$$ ## #
 ##  ## . ##  ##
### $##$.$##$ ###
# $ $ $...$ $ $ #
#.......@.......#
# $ $ $...$ $ $ #
### $##$.$##$ ###
 ##  ## . ##  ##
 # ## $$.$$ ## #
 ####   .   ####
   # ##$.$## #
   #### . ####
      #####