     ######
 ####  ####
 ##  *.  ##
 #  *$$.  #
 # *  .$. #
# *$ @ $* #
# .$.  * #
#  .$$*  #
##  .*  ##
####  ####
######