   #####
 ###   #####
 #    #    #
 # $.$.$.$ ##
 # .$.$.$.  #
## $.$.$.$  #
# #.$.#.$.# #
#  $.$.$.$ ##
#  .$.$.$. #
## $.$.$.$ #
 #    #    #
 #####@  ###
     #####