       ####
  ######  #
  #    #$.#
 ## ## #  #
 # $ $$$$ #
##.*.*.*..#
#     @   #
#   #######
#####