      ####
  #####  #
  # $ $$ #
  #   #  #
### ### ###
#   #     #
#...*.....#
## #$## ###
 # #  # #
##$#@ #$##
# $    $ #
#   ##   #
##########
    ##