      ######
      #    #
      # @  ###
####  #      #
#  ####..#.#$#####
# $ $ ##...      #
#     .....#$$   #
###### ##$## #####
     #  $    #
     #### ####
       #  #
       #  #####
     ### $    #
     #  $ $   #
     # #$# ####
     #     #
     #######