###################
##       #       ##
#   $$$  #  $$$ @ #
#  ##.## . ##.##  #
# $##.##$ $##.##$ #
# $.....$.$.....$ #
# $##.##$ $##.##$ #
#  ##.## . ##.##  #
#   $$$  #  $$$   #
###. . .###. . .###
#   $$$  #  $$$   #
#  ##.## . ##.##  #
# $##.##$ $##.##$ #
# $.....$.$.....$ #
# $##.##$ $##.##$ #
#  ##.## . ##.##  #
#   $$$  #  $$$   #
##       #       ##
###################