#########################
#   #   #   #   #   #   #
# $ # # # # # # # # # $ #
#  * * $ $ * * $ $ * *  #
### # # # # # # # # # ###
#  * *...... ......* *  #
# # # ###### ###### # # #
#  $ .#     $     #. $  #
### #$ $$$$ @ $$$$ $# ###
#  $ .#     $     #. $  #
# # # ###### ###### # # #
#  * *...... ......* *  #
### # # # # # # # # # ###
#  * * $ $ * * $ $ * *  #
# $ # # # # # # # # # $ #
#   #   #   #   #   #   #
#########################