     #####
 #####   #####
 #   # . #   #
 # $ $.$.$ $ #
 #  *.$.$.*  #
###$.$.$.$.$###
#  .$.$.$.$.  #
# .$.$.@.$.$. #
#  .$.$.$.$.  #
###$.$.$.$.$###
 #  *.$.$.*  #
 # $ $.$.$ $ #
 #   # . #   #
 #####   #####
     #####