  #########   #########
 ##   #   #####   #   ##
##.$.$. # $.$.$ # .$.$.##
# $.$.$ # .$ $. # $.$.$ #
# .$ $. #.$ $ $.# .$ $. #
# $.$.$ # .$ $. # $.$.$ #
##.$.$.## $.$.$ ##.$.$.##
#     #     .     #     #
# #####  ### ###  ##### #
#   .   #  . .  #   .   #
##$.$.$ # $.*.$ # $.$.$##
 #.$ $. #..$ $..# .$ $.#
 #$ $ $.  * @ *  .$ $ $#
 #.$ $. #..$ $..# .$ $.#
##$.$.$ # $.*.$ # $.$.$##
#   .   #  . .  #   .   #
# #####  ### ###  ##### #
#     #     .     #     #
##.$.$.## $.$.$ ##.$.$.##
# $.$.$ # .$ $. # $.$.$ #
# .$ $. #.$ $ $.# .$ $. #
# $.$.$ # .$ $. # $.$.$ #
##.$.$. # $.$.$ # .$.$.##
 ##   #   #####   #   ##
  #########   #########