      #####
     ##   ##
     #  $  #
    ## $.$ ##
   ## $.*.$ ##
 ### $.*.*.$ ###
##  $.*.$.*.$  ##
#  $.*.$ $.*.$  #
# $.*.$   $.*.$ #
#  $.*.$ $.*.$  #
##  $.*.$.*.$  ##
 ### $.*.*.$ ###
   ## $.*.$ ##
    ## $.$ ##
     #  $  #
     ## @ ##
      #####