 ######
 #    #
## ##.###
# .     #
# # #.# ###
# * $.$ * #
# $#$@$#$ #
# * $.$ * #
### #.# # #
  #     . #
  ###.## ##
    #    #
    ######