  ####  ####
  #  ####  ####
###     $ $   #
#    # $  *...##
# $ # #### #.. #
##   #         #
 # $$ $$@ #...##
 #   #  #######
 ####   # #
    #####