          #
     #   # #   #
    # # #   # # #
   #   #  *  #   #
  # .$ . $.$ . $. #
 #  $ * * * * * $  #
  #  * * * * * *  #
   #. * * * * * .#
  #  * * $ $ * *  #
 #  $ * $...$ * $  #
#  *.* * .@. * *.*  #
 #  $ * $...$ * $  #
  #  * * $ $ * *  #
   #. * * * * * .#
  #  * * * * * *  #
 #  $ * * * * * $  #
  # .$ . $.$ . $. #
   #   #  *  #   #
    # # #   # # #
     #   # #   #
          #