       #######
       # #  ##
       ###$ ##
       #   $ #
       # #   #
       # # . #########
########  #.###    # #
# ###  ##  .#   ## ###
###   $# ##* # #   $ #
#  $   ...*@ *..  $  #
# $ $  ## # *###   ###
### ###   ##.  #######
##      #  #.# ###
##   ## ####.#   #
##########    # ##
         #    # ##
         ##  $#  #
         ## $    #
         ### $#  #
         # #  ####
         #########