       ####
########@ #
#   ...#$ #
# $ $ $ * #
#####   . #
   ##$#$. #
 ###. # .##
 #  .$#$ #
 #  .$   #
 ###.$#  #
   #  ####
   ####