#########
#  #   #
#.$*$#.##
#  .$ $ #
## ...  #
# $  $ ##
# $###.#
#   @  ##
#########