#####  ####
#   ####  #
#      .  #
##$### #* #
 #  .$$# ##
 # #.@.# #
## #$$.  #
# *# ###$##
#  .      #
#  ####   #
####  #####