       #####
       #   ##
       #    #
#########.# #
#  $ $ $ $  #
#   ......###
### ##### #
 #  #   #.#
 # @  $ # #
 #  ##$## #
 ####  ##$##
    #  $   #
    #  #   #
    ########