####
#  #      #####
#  ########  @#
#  * * * *    #
##  * * *  *###
 #*  * *  * #
 # *  *  * *#
 #* *   * * #
 # * *   * *#
 #* *  *  * #
 # *  * *  *#
 #.  * * *  ##
 #  $ * * *  #
 ##########  #
          #  #
          ####