#############
#.    *    .#
# ##  #  ## #
#  ## $ ### #
#  ##$$$##  #
#   $...$   #
#.#$$.#.$$#.#
#   $...$   #
#.###$@$###.#
#   $...$   #
#.#$$.#.$$#.#
#   $...$   #
#  ##$$$##  #
# ### $ ##  #
# ##  #  ## #
#.    *    .#
#############