##############################
# .$ ## $. ## .$ ## $. ## .$ #
#$  .  .  $##$  .  .  $##$  .#
#.  $##$  .  .  $##$  .  .  $#
# $. ## .$ ## $. ## .$ ## $. #
### #  # ##  ## #  # ##  ## ##
### #  # ## #  . # # ##  ## ##
# $. ## .$ #   $  # .$ ## $. #
#.  $##$  . .$##  #$  .  .  $#
#$  .  .  $#  @#$. .  $##$  .#
# .$ ## $. #  $   # $. ## .$ #
## ##  ## # # .  # ## #  # ###
## ##  ## #  # ##  ## #  # ###
# .$ ## $. ## .$ ## $. ## .$ #
#$  .  .  $##$  .  .  $##$  .#
#.  $##$  .  .  $##$  .  .  $#
# $. ## .$ ## $. ## .$ ## $. #
##############################