        #
 ###########
 #   #  #  #
 # $ #$ $  #
 #$.*.*.#* #
 # .    $. #
 #$.$#.  .$#
## .$   #* ##
#  .#.*##.  #
# $ $   $   #
### # # #####
  ##@   #
   ######