 ###############
##             ##
#  ##### #####  # ###########
# # . . . . . # ###         ##
# #$ $ $ $ $ $#     ### ###  #
# # .#.#.#.#. # ## # . . . # #
# #$ $ $ $ $ $# ## #$ $ $ $# #
# # .#.#.#.#. # ## # .#.#. # #
#  $ $ $@$ $ $  ##  $ $ $ $  #
# # .#.#.#.#. # ## # .#.#. # #
# #$ $ $ $ $ $# ## #$ $ $ $# #
# # .#.#.#.#. # ## # . . . # #
# #$ $ $ $ $ $#     ### ###  #
# # . . . . . # ###         ##
#  ##### #####  # ###########
##             ##
 ###############