      #####
      #   #
     ## $ ##
   ### $.$ ###
   #  $.*.$  #
  ## $.*.*.$ ##
### $.*.$.*.$ ###
#  $.*.$ $.*.$  #
# $.*.$   $.*.$ #
#  $.*.$ $.*.$  #
### $.*.$.*.$ ###
  ## $.*.*.$ ##
   #  $.*.$  #
   ### $.$ ###
     ## $ ##
      # @ #
      #####