     #########
 #####       #
##      #### #
# $ #  @ *..*###
#  #  # #....  #
#  #$#  #....  #
# $# # ##$###  #
#    #$       ##
##  $  $#  ####
 ##  $  ####
  ### $$ #   #
    #    # ###
    ######