   #####
   #   #
 ### . ###
 ## * * ##
 # * . * #
 #  *$*  #
 # *   * #
 ## * * ##
  ## * ##
####. .####
# $ $.$ $ #
#   ***   #
###  @  ###
 #########