   ####
  ##  #####
###  @ #  #
# $*$.$*$ #
#  . . .  #
## .$*$. ##
 ##  #  ##
  ####  #
   ######