                #
               # #
              # # #
             #  *  #
            #  * *  #
           #  * $ *  #
          ## * $#$ * ##
         #  . * $ * .  #
        #  * . * * . *  #
       #  * * . * . * *  #
      #  * $ *  .  * $ *  #
     ## * $#$ * # * $#$ * ##
    #  . * $ *  *  * $ * .  #
   #  * . * * . * . * * . *  #
  #  * * . * .#* *#. * . * *  #
 #  * $ *     * $ *     * $ *  #
# #* $#$ *.#** $@$ **#.* $#$ *# #
 #  * $ *     * $ *     * $ *  #
  #  * * . * .#* *#. * . * *  #
   #  * . * * . * . * * . *  #
    #  . * $ *  *  * $ * .  #
     ## * $#$ * # * $#$ * ##
      #  * $ *  .  * $ *  #
       #  * * . * . * *  #
        #  * . * * . *  #
         #  . * $ * .  #
          ## * $#$ * ##
           #  * $ *  #
            #  * *  #
             #  *  #
              # # #
               # #
                #