   ##### #####
   # @ ###   #
   # # $     #
#### #$ $ ####
#    # $ $#
# ### $ $ #
#.......# ##
#### ## #  #
   #    #  #
   ######  #
        ####