#############
#           #
# .$.$.$.$. #
# $.$.$.$.$ #
# .$.$.$.$. #
# $.$.$.$.$ #
# .$.$@$.$. #
# $.$.$.$.$ #
# .$.$.$.$. #
# $.$.$.$.$ #
# .$.$.$.$. #
#           #
#############