            ########
            ####   #
      #######  $*. #
      ####  $*.   ##
#######  $*.   #####
####  $*.   ########
# @$*.   ####
#     #######
#  ####
#######