  ########
 ## .   @#
## .$.$. #
#  $.$* ##
# $.$* ##
####   #
   #   #
   #####