       #
    #######
    #  #  #
   ##.$#$.##
 ###   #   ###
 # . .$.$. . #
 # $ $.$.$ $ #
#####.$@$.#####
 # $ $.$.$ $ #
 # . .$.$. . #
 ###   #   ###
   ##.$#$.##
    #  #  #
    #######
       #