          #
         # #
        # # #
       # # # #
      # #   # #
     # #  *  # #
    # # .$.$. # #
   # # .$ # $. # #
  # # .$ # # $. # #
 # #  $ # # # $  # #
# #  *.# # # #.*  # #
 # #  $ # # # $  # #
  # # .$ # # $. # #
   # # .$ # $. # #
    # # .$.$. # #
     # #  *  # #
      # #   # #
       # #@# #
        # # #
         # #
          #