  #####
  #   #####
  # $$#   #####
  #   . $ #   #####
 ### ##   . $ #   #####
 #   ##.### ....$ #   #####
 # $$#   ###.##.  # $ #   #
 #   # $ #  .##.###   .$$ #
### ##   .$$$#   ###.##   #
#   ##.###   #$$$.   ## ###
# $$.   ###.##.  # $ #   #
#   # $ #  .##.###   #$$ #
#####   # $.... ###.##   #
    #####   # $ .   ## ###
        #####   # $ .   #
            #####   #$$ #
                #####  @#
                    #####