   ####    ######
#### @######    #
#          #    #
# ###*## $ $ #$##
# #... #####   #
# #*...    $ #$#
#  *...# #     #
### #### $ $ $$#
  #    ####### #
  ####         #
     ###########