 ####
 #  #
 #@ #
 #  ####
### ## #
#    * #
#  $   #
#####. #
 # ## ###
 # *    #
 #   $  #
 # .#####
### ## #
#    * #
#  $   #
#####. #
 # ## ###
 # *    #
 #   $  #
 # .#####
 ####