     ###
   ##   ##
  #   #   #
 # # . . # #
 #   $*$   #
#  .$# #$.  #
# # * @ * # #
#  .$# #$.  #
 #   $*$   #
 # # . . # #
  #   #   #
   ##   ##
     ###