 ###########
##    #    ##
# $.$.$.$.$ #
# .$.$.$.$. #
# $.$.$.$.$ #
# .$.   .$. #
##$.$ @ $.$##
# .$.   .$. #
# $.$.$.$.$ #
# .$.$.$.$. #
# $.$.$.$.$ #
##    #    ##
 ###########