        ####
        #  ######
        #$   #  ######
      ###   $#$   #  ###
   ####.. $  #   $#$   #
   # $ ..###.. $  #   $#
  ##   #  $ ..###.. $  ##
  #   $#$## #  $ ..###..#
  # $  # ##$#$## #  $ ..####
  ####.. $  # ##$#$## #  $ #
  # $ ..###.. $  # ##$#$   #
 ##   #  $ ..###.. $  #   ##
 #   $#$## #  . ..###.. $ #
 # $  # ##$#.## #  $ ..####
 ####.. $  # ##.#$## #  $ #
 # $ ..###.. .  # ##$#$   #
##   #  $ ..###.. $  #   ##
#   $#$## #  $ ..###.. $ #
# $  # ##$#$## #  $ ..####
####.. $  # ##$#$## #  $ #
   #..###.. $  # ##$#$   #
   ##  $ ..###.. $  #   ##
    #$   #  $ ..###.. $ #
    #   $#$   #  $ ..####
    ###  #   $#$   ###
      ######@ #   $#
           ######  #
                ####