            #########
            ####  ###
      #######  $*. ##
      ####  $*.     #
#######  $*.   .*$  #
####  $*.   .*$  ####
# @$*.   .*$  #######
#     .*$  ####
## .*$  #######
###  ####
#########