  #######
###  #  #
#  .$$. ##
#  *  *@ #
## .$$.  #
 #  #  ###
 #######