#################
#    #     #    #
# #  #  #  #  # #
#  $.$.$.$.$.$  #
#  .$.$.$.$.$.  #
###$.$.$.$.$.$###
#  .$.$.$.$.$.  #
#  $.$.$.$.$.$  #
# #.$.$.@.$.$.# #
#  $.$.$.$.$.$  #
#  .$.$.$.$.$.  #
###$.$.$.$.$.$###
#  .$.$.$.$.$.  #
#  $.$.$.$.$.$  #
# #  #  #  #  # #
#    #     #    #
#################