 # ## ####
## #  #  ###
   # ##$   #
#### # * # #
#    # * # #
  #### * # #
###    . # #
#@#.****$# #
#        # #
# #####  # #
#      ##  #
######    ##
     ######