   #    #    #    #    #
   #####################
  ##    #    #    #    ##
### .$$. .$$. .$$. .$$. ###
 # .*  *.*  *.*  *.*  *. #
 # $ ## $ ## $ ## $ ## $ #
 # $ ## $ ## $ ## $ ## $ #
 # .*  *.*  *.*  *.*  *. #
### .$$. .$$.@.$$. .$$. ###
 # .*  *.*  *.*  *.*  *. #
 # $ ## $ ## $ ## $ ## $ #
 # $ ## $ ## $ ## $ ## $ #
 # .*  *.*  *.*  *.*  *. #
### .$$. .$$. .$$. .$$. ###
  ##    #    #    #    ##
   #####################
   #    #    #    #    #