   ########
  ##   # ##
 ## $.$  ##
## $.$.$ ##
## .$.$.###
# .$.$.$ ##
# $.$ $. ##
##.$.$.$.##
# $.$.$.$ #
#   . .   #
#####@#####
   #  #
#### ###
## #   ##
##  $.$ ##
## $.$.$ ##
###.$.$. ##
## $.$.$. #
## .$ $.$ #
##.$.$.$.##
# $.$.$.$ #
#   . .   #
###########