  ########
 ##.... @#
 #  # .  #
## #  # ##
#  #$ # #
# $   # ##
###$ ##  #
  #   $$ #
  #   #  #
  ########