           #####
          ## . ##
         ##.$ $.##
         # $ * $ #
         #. * * .#
         # $ * $ #
         ##.$ $.##
 #######  ## . ##  #######
##     ##  ## ##  ##     ##
# .$.$. #   # #   # $.$.$ #
# $.$.$ ##### ##### .$.$. #
# .$ $.             $.@.$ #
# $.$.$ ########### .$.$. #
# .$.$. #         # $.$.$ #
##     ##  #####  ##     ##
 #######   #***#   #######
           #####