       #######
      ##  .  #
    ### $$ @ #
   ##  ...$###
 ### $$ $ .###
##  ...$######
# $$ $ .#### #
# ..$#########
# $ .### # # #
##############