   #######
 ####  #####
 #  #  $ $ #
##$.#$ . . ##
##  # .######
##$.#* * $  #
#   . @ .   #
#  $ * *#.$##
######. #  ##
## . . $#.$##
 # $ $  #  #
 #####  ####
   #######