########
###  ###
#  $   #
# $ $  #
#  $ $ #
# $$$$ #  ######
## # ######    ###
##@......... #   ###
###########    #   #
          # #    # #
          #   #    #
          ##    # ##
           # #    #
           #   # ##
           ###   #
             #####