  #####
  #  ####
### *$ ####
#    . $ ##
# * # .   ##
##$. # # $##
##  . @ .  ##
 ##$ # # .$##
 ##   . # * #
  ## $ .    #
  #### $* ###
    ####  #
      #####