  #########
  #   @   #
### # # # ##
#  .$.$.$. ###
# #$.$.$.$   #
#  .$# # # # #
# #$.$.$.$.  #
#  .$.$.$.$# #
# # # # #$.  #
#   $.$.$.$# #
### .$.$.$.  #
  ## # # # ###
   #       #
   #########