# ##       ## #
 #  #######  #
#      .      #
#  # ## ## #  #
 #  #  $  #  #
 # #  *.*  # #
 # # * $ * # #
 #. $.$+$.$ .#
 # # * $ * # #
 # #  *.*  # #
 #  #  $  #  #
#  # ## ## #  #
#      *      #
 #  #######  #
# ##       ## #