 ####### #######
##  .  ###     ##
# $$.$$ # .$.$. #
# $ . $ # $.$.$ #
#...#...  .$@$. #
# $ . $ # $.$.$ #
# $$.$$ # .$.$. #
##  .  ###     ##
 ### ### ### ###
##     ###     ##
# .$.$. # .$$$. #
# $.$.$ # $...$ #
# .$ $.   $.#.$ #
# $.$.$ # $...$ #
# .$.$. # .$$$. #
##     ###     ##
 ####### #######