###############
#      #      #
# #.$.$.$.$.# #
# .$.$.$.$.$. #
# $.$.$.$.$.$ #
# .$.$.$.$.$. #
# $.$.$ $.$.$ #
##.$.$ @ $.$.##
# $.$.$ $.$.$ #
# .$.$.$.$.$. #
# $.$.$.$.$.$ #
# .$.$.$.$.$. #
# #.$.$.$.$.# #
#      #      #
###############