          #########
          ####  ###
    #######  $*.  #
    ####  $*.     #
#####  $*.   ### $###
##  $*.   #### # * ##
##     ####    # . ##
# . ####   #   ## $##
# * #   # # # # # * #
##$ ##   #   #  # . #
## . #  # # # # ## $###
## * # #   #   # # * ##
###$ ## # # # #  # . ##
  # . #  #   #   ## $##
  # * # # # # #   # * #
  ##$ ##   #   #### . #
  ## . #    ####     ##
  ## * # ####   .*$  ##
  ###$ ###   .*$  #####
    #     .*$  ####
    #  .*$  #######
    ###@ ####
    #########