          ####
          #  #
          #  #
          #  #
############ #
##   $ $ $ $$#
# @  $..*.*. #
#   # * .* .$#
#####$.*  .* #
    # *.  *.$#
    #$. *. * #####
    # .*.*..$#   #
    #$$ $ $ $    #
    # ############
    #  #
    #  #
    #  #
    ####