 ###############
##      #      ##
# *$ $*$$$*$ $* #
# $...$...$...$ #
#  .$.$.$.$.$.  #
# $...$...$...$ #
# *$$$*$$$*$$$* #
# $...$...$...$ #
##$.$.$.@.$.$.$##
# $...$...$...$ #
# *$$$*$$$*$$$* #
# $...$...$...$ #
#  .$.$.$.$.$.  #
# $...$...$...$ #
# *$ $*$$$*$ $* #
##      #      ##
 ###############