        #
       # #
      #   #
     # $.  #
    #  * *  #
   #  * * *  #
  #  * * * *  #
 #  * * * * *$ #
#  . * *@* * .  #
 # $* * * * *  #
  #  * * * *  #
   #  * * *  #
    #  * *  #
     #  .$ #
      #   #
       # #
        #