      ########
      #      #
     ##* * . #
     ## * * ##
     # * *  ##
 #####  * $ #
 #  ##  ##  #
 # * *  #####
##  * * #
## * * ##
# . * *##
# #$   #
#@  ####
#####