             ###
      #################
  ######   ##   ##   ######
####   # $$   #   $$ #   ####
#  #$$     #.. ..#     $$#  #
#      ### #.###.# ###      #
#* ##### ### #*# ### ##### *#
#           ..@..           #
#* ##### ### #*# ### ##### *#
#      ### #.###.# ###      #
#  #$$     #.. ..#     $$#  #
####   # $$   #   $$ #   ####
  ######   ##   ##   ######
      #################
             ###