   #### ####
  ##  ###  #####
###    #   #   #
# $*$.$*$.$*$  #
#  . . . . .  ##
## .$*$.$*$. ##
 ##  # @#   ##
  ####  #####
     ####