       #
      # #
    ##   ##
    #  .  #     #
  ## $.$.$ ##  # #
  # $.$.$.$ # # . #
 #  .$.$.$.  # $.$ #
#  .$.$@$.$.    *   #
 #  .$.$.$.  # $.$ #
  # $.$.$.$ # # . #
  ## $.$.$ ##  # #
    #  .  #     #
    ##   ##
      # #
       #