#############
#  .  #  .  #
# $ * # * $ #
####$.#.$####
 ###     ###
 #   ***   #
 # $ $.$ $ #
 ####...####
    # @ #
 ####...####
 # $ $.$ $ #
 #   ***   #
 ###     ###
####$.#.$####
# $ * # * $ #
#  .  #  .  #
#############