           ####
         ###  #
  ######## $$ ##
###   #   .*.$ #
#  $$ # #....$ #
# $.. # $ $    #
##$*. ##  ######
 # ..$## ###   #
 ## .  #    $# #
  # #$   @#  . ##
  #   ### ##$.. #
  ######  ## .*$##
  #    $ $ # ..$ #
  # $....# # $$  #
  # $.*.   #   ###
  ## $$ ########
   #  ###
   ####