         #####   ####
         #   #####  #
         #   $ $    #
         ## ## ###  #
          #   .  # ##
          #$#....#*#
########### # .$ # #
#   #  ##   ### ## ##
#   $  $  #  $  $   #
## ## ###   ##  #   #
 # # $. # ###########
 #*#....#*#
## #  .   ###
#  ###@##$  #
#    $ $    #
#  ######   #
####    #####