     #######
 ######   ######
 ##   $. .$   ##
 # $ $.$#$.$ $ #
 #  #.$.$.$.#  #
## $. .$.$. .$ ##
##$.$.#.$.#.$.$##
# .$.$.   .$.$. #
#  #$.$ @ $.$#  #
# .$.$.   .$.$. #
##$.$.#.$.#.$.$##
## $. .$.$. .$ ##
 #  #.$.$.$.#  #
 # $ $.$#$.$ $ #
 ##   $. .$   ##
 ######   ######
     #######