###### ######
#    ####   #
#  #   #    #
#  $.* *.$# #
## .$ . $.  #
###*#$*$#*###
#  .$ . $. ##
# #$.* *.$  #
#    #   #  #
#   ####   @#
###### ######