      #   #   #
 ###################
 #    #   #   #    #
 # #  #   #   #  # #
 #  **$***$***$**  #
 #  *   .   .   *  #
####$ #### #### $####
 #  * ## #.# ## *  #
 #  *.# ## ## #.*  #
 #  * ###   ### *  #
####$  .  @  .  $####
 #  * ###   ### *  #
 #  *.# ## ## #.*  #
 #  * ## #.# ## *  #
####$ #### #### $####
 #  *   .   .   *  #
 #  **$***$***$**  #
 # #  #   #   #  # #
 #    #   #   #    #
 ###################
      #   #   #