####################
#   . $  ..   $.   #
#  . * $ ..  $.$.  #
# . * * $ $ $.$.$. #
#. * * * *.$.$.$.$.#
# * * * *.*.$.$.$.$#
#$ * * * $ $.$.$.$ #
# $ * $.$.$ * $.$  #
#  $.$ * $.$.$ * $ #
# $.$.$.$ $ * * * $#
#$.$.$.$.*.* * * * #
#.$.$.$.$.* * * * .#
# .$.$.$ $ $ * * . #
#  .$.$  .. $ * .  #
#   .$   ..  $ .  @#
####################