  #############################
  #                           #
### # # # # # # # # # # # # # ###
#  $.$.$.$.$.$.$.$.$.$.$.$.$.$  #
# #.$.$.$.$.$.$.$.$.$.$.$.$.$.# #
#  $.$.$.$.$.$.$.$.$.$.$.$.$.$  #
# #.$.$.$.$.$.$.$.$.$.$.$.$.$.# #
#  $.$.$.$.$.$.$.$.$.$.$.$.$.$  #
# #.$.$.# # # # # # # # #.$.$.# #
#  $.$.$                 $.$.$  #
# #.$.$.# # # # # # # # #.$.$.# #
#  $.$.$   $.$.$.$.$.$   $.$.$  #
# #.$.$.# #.$.$.$.$.$.# #.$.$.# #
#  $.$.$   $.$.$.$.$.$   $.$.$  #
# #.$.$.# #.$.$.$.$.$.# #.$.$.# #
#  $.$.$   $.$.$.$.$.$   $.$.$  #
# #.$.$.# #.$.$.@.$.$.# #.$.$.# #
#  $.$.$   $.$.$.$.$.$   $.$.$  #
# #.$.$.# #.$.$.$.$.$.# #.$.$.# #
#  $.$.$   $.$.$.$.$.$   $.$.$  #
# #.$.$.# #.$.$.$.$.$.# #.$.$.# #
#  $.$.$   $.$.$.$.$.$   $.$.$  #
# #.$.$.# # # # # # # # #.$.$.# #
#  $.$.$                 $.$.$  #
# #.$.$.# # # # # # # # #.$.$.# #
#  $.$.$.$.$.$.$.$.$.$.$.$.$.$  #
# #.$.$.$.$.$.$.$.$.$.$.$.$.$.# #
#  $.$.$.$.$.$.$.$.$.$.$.$.$.$  #
# #.$.$.$.$.$.$.$.$.$.$.$.$.$.# #
#  $.$.$.$.$.$.$.$.$.$.$.$.$.$  #
### # # # # # # # # # # # # # ###
  #                           #
  #############################