   #######
 ##  #   #
 ## $.$  #
#   .$.$#####
# $. .$.$   #
##.$. .$.$  #
# $.$. .$.$#####
#  $.$. .$.$   #
#   $.$. .$.$  #
#####$.$. .$.$#####
   #  $.$. .$.$   #
   #   $.$. .$.$  #
   #####$.$.@.$.$#####
      #  $.$. .$.$   #
      #   $.$. .$.$  #
      #####$.$. .$.$#####
         #  $.$. .$.$   #
         #   $.$. .$.$  #
         #####$.$. .$.$ #
            #  $.$. .$.##
            #   $.$. .$ #
            #####$.$.   #
               #  $.$ ##
               #   #  ##
               #######