        #
       # #
     ##   ##
     # $.$ #
    #  . .  #
  ## $.$.$.$ ##
  #  . # # .  #
 # $.$# $ #$.$ #
#  . . $@$ . .  #
 # $.$# $ #$.$ #
  #  . # # .  #
  ## $.$.$.$ ##
    #  . .  #
     # $.$ #
     ##   ##
       # #
        #