####  #####
#  ####   #
#     # $ #
## $.$*   #
 # .*.#*###
 # $.@.$ #
###*#.*. #
#   *$.$ ##
# $ #     #
#   ####  #
#####  ####