  #########
  #       #####
  # ##### .  ##   ########
  # #   #* .  #####      #
  # # $   . #       #### #
  # ## ###$##########  # #
  #  # ## $          $ # #
  ## #  # # #####  ##  # #
   # #  #   ##  ##### ## #
   # # ###$######   # *  #
   # # # #.#   .$ #$$. .##
 ### # # # .$ .##   # . #
 ##  # ###  ##$ ### ##  #
 #  ## ### $##  ### #  ##
 # . #   ##. $. # # # ###
##. .$$# $.   #.# # # #
#  * #   ######$### # #
# ## #####  ##   #  # #
# #  ##  ##### # #  # ##
# # $          $ ## #  #
# #  ##########$### ## #
# ####   @   # .   $ # #
#      #####  . *#   # #
########   ##  . ##### #
           #####       #
               #########