 ####
 #  ###
 # $* ###
 #  . $ ###
### # ..$ #######
#   .*# . $ #   #
# # $ .$#$. $ # #
#   # $ . #*.   #
####### $.. #@###
      ### $ .  #
        ### *$ #
          ###  #
            ####