  #####     #####
 ##   #     #   ##
##  * ####### *  ##
#  * *   +   * *  #
# * * *  $  * * * #
#  * * ## ## * *  #
### * #     # * ###
  #  # * # * #  #
  #  #  # #  #  #
  #.$  # # #  $.#
  #  #  # #  #  #
  #  # * # * #  #
### * #     # * ###
#  * * ## ## * *  #
# * * *  $  * * * #
#  * *   .   * *  #
##  * ####### *  ##
 ##   #     #   ##
  #####     #####