              ####
              #  ####
          #####  #  #
###########   $     #
#  #  #   # # ##*#  #
#  $   $# #. .$. .*##
#  #*## #   # ##*#  #
##*.@.$. .# #$   $  #
#  #*## # #   #  #  #
#     $   ###########
#  #  #####
####  #
   ####