      ####
#######  #
#    *   #
#  .$.$. #
## $###$ #
 #*.# #.*#
 # $###$ ##
 # .$.$.  #
 #   *    #
 #@  ######
 #####