           #
          # #
         # . #
    ### # . . # ###
   #   # .   . #   #
   # $ $.$.$.$.$ $ #
   #  $.$ $.$ $.$  #
    #$.$.$.$.$.$.$#
   # .$.$.$.$.$.$. #
  # .$ $.$.$.$.$ $. #
 # . .$.$.$ $.$.$. . #
# .  $.$.$ @ $.$.$  . #
 # . .$.$.$ $.$.$. . #
  # .$ $.$.$.$.$ $. #
   # .$.$.$.$.$.$. #
    #$.$.$.$.$.$.$#
   #  $.$ $.$ $.$  #
   # $ $.$.$.$.$ $ #
   #   # .   . #   #
    ### # . . # ###
         # . #
          # #
           #