  ####
  #  #
### $####
#  .$. ##
# $ . $##
## #$.$ #
#  $. #@#
#  * .  #
# .$.# ##
####   ##
   #####