    #####
    #   #
   ##$  #
  ## *. #
  # .$ ##
 ## .* #
 # $@$ #
 # *. ##
## $. #
# .* ##
#  $##
#   #
#####