    #####
#####   ##
#   # #$ #
# #  *.  ##
# $*.@.*$ #
##  .*  # #
 # $# #   #
 ##   #####
  #####