      #########
      #       #
     ##$ .$. $##
   #### .* *. ####
   ## $*.$#$.*$ ##
  ##  ..  #  ..  ##
####$..$$ # $$..$####
# $ *.$# $#$ #$.* $ #
#  .. $ #.#.# $ ..  #
# .*$  $.   .$  $*. #
# $ ##### # ##### $ #
# .*$  $. @ .$  $*. #
#  .. $ #.#.# $ ..  #
# $ *.$# $#$ #$.* $ #
####$..$$ # $$..$####
  ##  ..  #  ..  ##
   ## $*.$#$.*$ ##
   #### .* *. ####
     ##$ .$. $##
      #       #
      #########