###################################
##  #######   #########       #####
##  $ $ ### # ########  ###    #  #
## #*.. ### $.*  # $.$ *### #$.*  #
#  .   #### .$ * #  . . ###  .$ * #
# $$..$$ ###*#$. ###*. $$ ###*#$. #
###   .  #  .$ * ## . .   ## .$ * #
## ..*# ## #$.*  ##$. $.#### $.*  #
#  $ $  ##    #  # $ #$ #### # ## #
# ####  ##   ### #      ####   ## #
# #####    ##### @ ############## #
# ##################      ###     #
# ##  #  #####  #  # # $$ $ $ $$ ##
#    **$ $ #   $*$   ### .# #. ####
## # .$.   # # .$. # ### ..  . ####
## ##.. ## # #$...$# ####.#*#.#####
##   .$. # # # .$. # ### .  .. ####
## $ **$   #   *$*   ### .# #. ####
####  #  #####  #  ### $$ $ $ $$ ##
########       #######    ###    ##
###################################