###############
#             #
# $.$.$.$.$.$ #
# .$.$.#.$.$. #
# $.$.$ $.$.$ #
# .$.$.#.$.$. #
# $.$.$ $.$.$ #
# .# # @ # #. #
# $.$.$ $.$.$ #
# .$.$.#.$.$. #
# $.$.$ $.$.$ #
# .$.$.#.$.$. #
# $.$.$.$.$.$ #
#             #
###############