 #####
 #   #####
 # #$$ $ #
## .@.   #
# *.#..###
#   $$  #
#####   #
    #####