  ####
###  #
#  ..# #######
# #..# #     ####
# #. ###   $    #
# #.   # $ $ $$ #
# #  @ ### $##  #
#           #####
##  #########
 ####