   #############
  ##           #
 ##  #########@###
##  #         *  #
#  ## ########*# #
# #  $ $ $ $   # #
# #$.. . . ..$#  #
# # .#######. # ##
#  $.#######.$# #
### . . . . . # #
  # $ $ $ $ $ # #
  ######### ##  #
          # $ $ #
          #     #
          #######