    #######
  ###     ###
 ##    #    ##
 # $#$.$.#.$ #
## .$.#.$.$# ##
#  #.$.$.$.$  #
#  .$.$ $.#.  #
# #$.$ @ $.$# #
#  .#.$ $.$.  #
#  $.$.$.$.#  #
## #$.$.#.$. ##
 # $.#.$.$#$ #
 ##    #    ##
  ###     ###
    #######