            #
     #     # #     #
    # #   #   #   # #
   #   ###  *  ###   #
  #  $ . . $ $ . . $  #
 #  $ * * * * * * * $  #
  #  * * * * * * * *  #
   #. * * * $ * * * .#
   # * * * * * * * * #
   #. * * * . * * * .#
  #  * * * * * * * *  #
 #  $ * * *   * * * $  #
#  * * $ .  @  . $ * *  #
 #  $ * * *   * * * $  #
  #  * * * * * * * *  #
   #. * * * . * * * .#
   # * * * * * * * * #
   #. * * * $ * * * .#
  #  * * * * * * * *  #
 #  $ * * * * * * * $  #
  #  $ . . $ $ . . $  #
   #   ###  *  ###   #
    # #   #   #   # #
     #     # #     #
            #