     #######
     #  ####
  ####  ####
  #   .*. ##
  #   # *  #
  # * ## $ #
  # .#@ # ##
  # * $ $ #
  # .#$   #
  # *  ####
  #  ######
  #########