  #####
  #   #####
### #     ##
#  * ####  #
#  * ##  # #
#  *  ** # #
#   #    # #
#@#** * ## #
###  #$  # #
 # .$ .* # #
 #   #  #  #
 ##  #    ##
  #########