            #         #
  ##### ######### ######### #####
 ##   ###   #   ###   #   ###   ##
 # $.$. .$.$ $.$. .$.$ $.$. .$.$ #
 # .$.$ $.$. .$.$ $.$. .$.$ $.$. #
 # $.$. .$.$ $.$. .$.$ $.$. .$.$ #
 ##.$.$#$.$. .$.$#$.$. .$.$#$.$.##
  #    #   ###   #   ###   #    #
 ##.$.$#$.$. .$.$#$.$. .$.$#$.$.##
 # $.$. .$.$ $.$. .$.$ $.$. .$.$ #
 # .$.$ $.$. .$.$ $.$. .$.$ $.$. #
 # $.$. .$.$#$.$. .$.$#$.$. .$.$ #
###   ###   #   ###   #   ###   ###
 # $.$. .$.$#$.$. .$.$#$.$. .$.$ #
 # .$.$ $.$. .$.$ $.$. .$.$ $.$. #
 # $.$. .$.$ $.$. .$.$ $.$. .$.$ #
 ##.$.$#$.$. .$.$ $.$. .$.$#$.$.##
  #    #   ###   @   ###   #    #
 ##.$.$#$.$. .$.$ $.$. .$.$#$.$.##
 # $.$. .$.$ $.$. .$.$ $.$. .$.$ #
 # .$.$ $.$. .$.$ $.$. .$.$ $.$. #
 # $.$. .$.$#$.$. .$.$#$.$. .$.$ #
###   ###   #   ###   #   ###   ###
 # $.$. .$.$#$.$. .$.$#$.$. .$.$ #
 # .$.$ $.$. .$.$ $.$. .$.$ $.$. #
 # $.$. .$.$ $.$. .$.$ $.$. .$.$ #
 ##.$.$#$.$. .$.$#$.$. .$.$#$.$.##
  #    #   ###   #   ###   #    #
 ##.$.$#$.$. .$.$#$.$. .$.$#$.$.##
 # $.$. .$.$ $.$. .$.$ $.$. .$.$ #
 # .$.$ $.$. .$.$ $.$. .$.$ $.$. #
 # $.$. .$.$ $.$. .$.$ $.$. .$.$ #
 ##   ###   #   ###   #   ###   ##
  ##### ######### ######### #####
            #         #