## ##### ##
####  #####
 #  $.$  #
## #.. # ##
##$ $ $.$ #
# .. # .. #
# $.$ $ $##
## # ..# ##
 #  $.$  #
#####@ ####
## ##### ##