  #######
 ##     ##
###$   $###
# $.* *.$ #
#  *.*.*  #
#   *@*   #
#  *.*.*  #
# $.* *.$ #
###$   $###
 ##     ##
  #######