    ####
 ####  ##
 #  # *###
##.$#  * ##
#   @ * * #
#   #  *  #
##### * * #
    ## * ##
    ##   #
     ##  #
      ####