####
#  #####  #####
#      ## #   #
#  ###  ### # ###
#  #  #  ##  $  #
#      #  #  $  #
#  #    # $$ #  #
#####   ### $####
   #  ###@##  #
   #    .... .#
   ##  ########
    ####