#####     #####
#   #######   #
# $    @    $ #
## ######### ##
## ###....## #
#         ## ###
# # # # .## $  #
#   #   . #  # #
########  $    #
#   #  ### $ ###
# # # # # $  #
##  #   #    #
 #############