           #####
 ########### @ ###########
 #  .     .  #    .$.    #
 # .$.$$$.$. #.$  $.$  $.#
 #.$$$.*.$$$.#$.*** ***.$#
## .$.$$$.$. #.$  $.$  $.##
#   .     .  #    .$.     #
# ####################### #
#   $.   .$  # $       .  #
##  * .$. *  # .**   **$ ##
 #  $.$*$.$  # *  ***  * #
 #  * .$. *  # $**   **. #
 #  $.   .$  # .       $ #
 ########### * ###########
           #####