    ##  ##
 ###########
 #  ##  ## #
 # #  *   ###
###  *$*   #
### * . *  #
 # *$.@.$* #
 #  * . * ###
 #   *$*  ###
###   *  # #
 # ##  ##  #
 ###########
   ##  ##