     ##
   ##  ##
  # $$ $ #
 #  *...  #
 #$. #  *$#
#  .  @#.$ #
# $.#   .  #
 #$*  # .$#
 #  ...*  #
  # $ $$ #
   ##  ##
     ##