    ####
    #  #
    #  #
    #  #
    # ##############
    #$$ $ $ $ $    #
    # .*.* *..$#   #
    #$. *.*. * #####
    # *. *  *.$#
    #$ *   *.* #
    # *.*   * $#
#####$.*  * .* #
#   # * .*.* .$#
# @  $..* *.*. #
##   $ $ $ $ $$#
############## #
            #  #
            #  #
            #  #
            ####