   ##### #####
 ###    #  @ ####
##    # $  #    ##
#   #..*.#*...#  #
# # . $# $ $# .  #
#   .#    #  $.#  #
#  #.$  #$   #*   #
 #. * #  $ #  .$# #
# $ #$ $$#$$ $# $ #
# #$.  # $  # * .#
#   *#   $#  $.#  #
#  #.$  #    #.   #
 #  . #$ $ #$ . # #
 #  #...*#.*..#   #
 ##    #  $ #    ##
  ####    #    ###
     ##### #####