      #
     # #
    #   #
   # $.$ #
  #  .$.  #
 # $.$.$.$ #
#  .$.@.$.  #
 # $.$.$.$ #
  #  .$.  #
   # $.$ #
    #   #
     # #
      #