     #####
  ####   #
  #   $  #
###  #$###
#  * .  #
# * * #@##
#  * *   #
### * *# #
  ## * . #
   ##   ##
    #####