#########
#   # # #
## $$   #
#  ...$ #
##$.@.$##
# $...  #
#   $$ ##
# # #   #
#########