                #############
         ########. . . .  ###
         #       $.$.$.$.$.##
######## # #####$.$.$.$.$.$ #
###  . ### #   #.$.$.$.$.$. #
##.$.$.$   # $   . ####.$.$.#
# $.$.$.##### ### ##  # .$. #
# .$.$.$#   #  # $  $ # $.$##
#.$.$.  # $  $ # # #  #### #
# .$.##### ##  #   # ##  # ####
#.$.$#   #  ##### # $  $ #    #
# .$.# $  $ #     #   #  #### #
#.$.$## ##  #$######### ##  # #
# .$. #   ###.#   .$ # $  $ # #
#.$.$. $#   # .$ .## #   #  # #
## $. #   # #  ##$ # ##### ## #
 # ## ##### # $##  # #   # .$ ##
 # #  #   # ##. $. #   #$ .$.$.#
 # # $  $ # $.   #.###   # .$. #
 # #  ## #########$#  ## ##$.$.#
 # ####  #   #     # $  $ #.$. #
 #    # $  $ # #####  #   #$.$.#
 #### #  ## #   #  ## #####.$. #
    # ####  # # # $  $ #  .$.$.#
   ##$.$ # $  $ #  #   #$.$.$. #
   # .$. #  ## ### #####.$.$.$ #
   #.$.$.#### .   $ #   $.$.$.##
   # .$.$.$.$.$.#   # ### .  ###
   # $.$.$.$.$.$##### # ########
   ##.$.$.$.$.$   @   #
   ###  . . . .########
   #############