      #######
 ######  .  ######
 #   #  . .  #   #
 #  $ $.$.$.$ $  #
 # $ $.$.$.$.$ $ #
 ## $.$.$.$.$.$ ##
## $.$.$.$.$.$.$ ##
#  .$.$.$.$.$.$.  #
# .$.$.$. .$.$.$. #
#. .$.$. @ .$.$. .#
# .$.$.$. .$.$.$. #
#  .$.$.$.$.$.$.  #
## $.$.$.$.$.$.$ ##
 ## $.$.$.$.$.$ ##
 # $ $.$.$.$.$ $ #
 #  $ $.$.$.$ $  #
 #   #  . .  #   #
 ######  .  ######
      #######