      #######
   ####     ##
   #    ###  #
  ## ###   # #
  # $.$.$  # #
  # * + * #  #
###.$.$ $.#  #
#   * * *  # #
# ######   # #
#       ###  #
#######     ##
      #######