              ####
              #  #
              #  #
              #  #
################ #
#    $ $ $ $ $ $$#
# @  $  *.*.*.   #
#   #  ..* $... $#
#####$... $ $..* #
    # *.$. $. *.$#
    #$.$ $.. $ * #
    # * $ ..$ $.$#
    #$.* .$ .$.* #
    # *..$ $ ...$#
    #$ ...$ *..  #####
    #   .*.*.*  $#   #
    #$$ $ $ $ $ $    #
    # ################
    #  #
    #  #
    #  #
    ####