#####  #####
#   #  #   #
# # #### # #
#  $ $ $$  #
###$.... ###
  # .##.$#
  #$.##. #
### ....$###
#  $$ $ $  #
# # ### ##@#
#   # #    #
##### ######