 #################
 #               #
##$#.#.#.#.#.#.#$##
#  $.$.$.$.$.$.$  #
#  #$#$ $@$ $#$#  #
#  $.$.$.$.$.$.$  #
##$#.#.#.#.#.#.#$##
 #               #
 #################