   ####
####  #
#  #. #
# $$  ###
#  #.   ##
#  #*##  #
# # *  # #
# @ * $  #
#   .## ###
####  #*  #
   ##   # #
    ###   #
      #####