  ########
  #@  #  ###
  # $  $   #
####$##$## #
# .* .* .*.#
#          #
##  #  #  ##
 ##########