           #####
############   #######
#     # # ## # # #   #
# # #$  $  # .$  $ # ##
#  ..*.** *@* **.*..  #
## # $  $. #  $  $# # #
 #   # # # ## # #     #
 #######   ############
       #####