 #############################
 #         *   *   *         #
 #  $ ### $  #####  $ ### $  #
 # $ $ ### $  ###  $ ### $ $ #
 #*#  $ ### $  #  $ ### $  #*#
 # ## .*.*.*.*.$.*.*.*.*. ## #
 # ###$ $ $ $ $.$ $ $ $ $### #
## ..*.....*...$...*.....*.. ##
##  $ $ $ $ $ *@* $ $ $ $ $  ##
## ..*.....*...$...*.....*.. ##
 # ###$ $ $ $ $.$ $ $ $ $### #
 # ## .*.*.*.*.$.*.*.*.*. ## #
 #*#  $ ### $  #  $ ### $  #*#
 # $ $ ### $  ###  $ ### $ $ #
 #  $ ### $  #####  $ ### $  #
 #         *   *   *         #
 #############################