  #####
  #.  #########
  #.# #####   #
  #*$         #
  #.##### # # #
 ##.#####$$ $ #
## .      ##$ #
#  @ #   ###  #
#   ###### ####
#####   ####