        #
       # #
      #   #
     # .$. #
    # .$.$. #
   #  $.$.$  #
  # .$.$.$.$. #
 # .$.$ $ $.$. #
#  $.$.$@$.$.$  #
 # .$.$ $ $.$. #
  # .$.$.$.$. #
   #  $.$.$  #
    # .$.$. #
     # .$. #
      #   #
       # #
        #