      ####
      #  #
#######$ #
#  $@$ $ #
# .*.*.  #
#  $*$  ##
##..$..##
 #  #  #
 #  #  #
 #######