     ####
 #####  #
##  $ * #
#  .$.$ #
# . * *@#
## .$.$.#
 #  $ * #
 ##  #  #
  #######