          #####
   ####  ##   ####
  ##  ####       #
 ##      #  ##.  #
##  $ #  #    .###
#  $# $$  ##.. ##
# $$ ##    #..  ##
#  $  # # # ..   #
## # # # # #$#   #
 #          $ #  #
 ########## + ####
          #####