  #############
  #           #
### # # # # # ###
#  $.$.$.$.$.$  #
# #.$.$.$.$.$.# #
#  $.$.$.$.$.$  #
# #.$.# # #.$.# #
#  $.$     $.$  #
# #.$.# @ #.$.# #
#  $.$     $.$  #
# #.$.# # #.$.# #
#  $.$.$.$.$.$  #
# #.$.$.$.$.$.# #
#  $.$.$.$.$.$  #
### # # # # # ###
  #           #
  #############