 #####
 # . ##########
 #            ##
### ### ####$$ #
# ... # # ## # ##
#     # ##   #  #
## #### #     # #
## #  # # $$  # #
#   @ # ##   #  #
#     # # #  # ##
###   # ###### #
  #####        #
      ##########