    ####
   ##  #######
  ##  * $ #  #
 ##  * *  ** ##
##  * * #@.*  #
#  * * ## **  #
#     ####   ##
###  ##  #   #
  ####   #####