    ####
   ##  ####
   # $   .########
   # $ # .   $ $ #
#### ### .#### # #
#  ....#$.#  # # #
# #. $ # .#$ # # #
#  ##  $$$@$ # # #
##   ##  #   # # #
 ###   #  ## # # #
   ### # ...     #
     # #$* *$#  ##
     # # ...$ ###
     # $$ #   #
     #   ######
     #####