          #####
  #########   #
### $ $ $ $.  #
#  .$.$ $.$.# #
# #.*..@..*.# #
# #.$.$ $.$.  #
#  .$ $ $ $ ###
#   #########
#####