# ############# #
  #  #     #  #
###  #  #  #  ###
#  $ *.$ $.* $  #
#   *.$.$.$.*   #
###*.$.$.$.$.*###
#  .$.$.$.$.$.  #
#  $.$.$.$.$.$  #
# # $.$.@.$.$ # #
#  $.$.$.$.$.$  #
#  .$.$.$.$.$.  #
###*.$.$.$.$.*###
#   *.$.$.$.*   #
#  $ *.$ $.* $  #
###  #  #  #  ###
  #  #     #  #
# ############# #