        ########
        ###  ###
     ####     ##
######   .*$ . #
###   .*$  # * #
## .*$  #####$ ##
#    ####   # . #
#  $##   #  # * #
## * #  # # ##$ ###
## . # #   # # . ##
### $## # #  # * ##
  # * #  #   ##$  #
  # . #   ####    #
  ## $#####  $*. ##
   # * #  $*.   ###
   # . $*.   ######
   ##     ####
   ###@ ###
   ########