      ####
  #####  #
###.  #$ ##
#  *   .*.#
# $.$ #$  #
### ###   #
 #   ### ###
 #  $# $.$ #
 #.*.@  *  #
 ## $#  .###
  #  #####
  ####