    #####
    #   #####
    # # #   #
    #     # #
 #####.# ...#####
 #  .$$ ###$#   #
 # #.#     $. # #
 #  .# $$$  #   #
###  # $@$ #  ###
#   #  $$$ #.  #
# # .$     #.# #
#   #$### $$.  #
#####... #.#####
    # #     #
    #   # # #
    #####   #
        #####