###       ###
#############
### . . . ###
 # .$ * $. #
 # $$$*$$$ #
 # .$ * $. #
### . + . ###
#############
###       ###