         #####     #####
        ##   ##   ##   ##
       ##.$.$.## ##.$.$.##
       ##$.$.$## ##$.$.$##
       # .$.$. # # .$.$. #
       # $.$.$ # # $.$.$ #
       # .$.$. # # .$.$. #
  ###### $.$.$ ### $.$.$ ######
 ###     .$.$.     .$.$.     ###
##.$.$.$.$.$.$.$.$.$.$.$.$.$.$.##
# $.$.$.$.$ $.$.$.$.$ $.$.$.$.$ #
# .$.$.$.$   $.$.$.$   $.$.$.$. #
# $.$.$.$.$ $.$.$.$.$ $.$.$.$.$ #
##.$.$.$.$.$.$.$.$.$.$.$.$.$.$.##
 ###     .$.$.# . #.$.$.     ###
  ###### $.$.$ #*# $.$.$ ######
       # .$.$..*@*..$.$. #
  ###### $.$.$ #*# $.$.$ ######
 ###     .$.$.# . #.$.$.     ###
##.$.$.$.$.$.$.$.$.$.$.$.$.$.$.##
# $.$.$.$.$ $.$.$.$.$ $.$.$.$.$ #
# .$.$.$.$   $.$.$.$   $.$.$.$. #
# $.$.$.$.$ $.$.$.$.$ $.$.$.$.$ #
##.$.$.$.$.$.$.$.$.$.$.$.$.$.$.##
 ###     .$.$.     .$.$.     ###
  ###### $.$.$ ### $.$.$ ######
       # .$.$. # # .$.$. #
       # $.$.$ # # $.$.$ #
       # .$.$. # # .$.$. #
       ##$.$.$## ##$.$.$##
       ##.$.$.## ##.$.$.##
        ##   ##   ##   ##
         #####     #####