  #####
  # @ #
### # #####
# $   ##  #
#  . ##   #####
#### ## $$ $  #
 # $   #      #
 #  .  ##$ ####
 #### ###  #
  # $   #  #
  #  .  #  #
  #### ### ###
   # $       #
   #  .....# #
   #######   #
         #####