  ##         #####
 ##  ######  #   ###
     #    # ##  $  #
 #####  ..### $$   #
##     #...   $  ###
#  @##  .###  $$ #
#        # ###  ##
#  ###  ##   #  #
#### ####    ####