#############
#     $   . #
#.$ $### *$ #
# ** ## .*  #
#  .$#..$ $ #
# # .$.$### #
#$##..@..##$#
# ###$.$. # #
# $ $..#$.  #
#  *. ## ** #
# $* ###$ $.#
# .   $     #
#############