   ###   ###
   #  ###  #
  #    #    #
##  $$$.$$$  ##
#  .# . . #.  #
#  . # $ # .  #
 # .$ #.# $. #
 ##$ .$@$. $##
 # .$ #.# $. #
#  . # $ # .  #
#  .# . . #.  #
##  $$$.$$$  ##
  #    #    #
   #  ###  #
   ###   ###