###########
#    *    #
# $$ ## $ #
#  $..#$$ #
# ##*.*.  #
#*#..@..#*#
#  .*.*## #
# $$#..$  #
# $ ## $$ #
#    *    #
###########