#############################
##  #################  ######
##  $ $ ####  #  #     $ $ ##
## #*.. ##   $*$   ## #*.. ##
#  .   ### # .$. # #  .   ###
# $$..$$ # #$...$# # $$..$$ #
###   .  # # .$. # ###   .  #
## ..*# ##   *$*   ## ..*# ##
## $ $     #  #  ###  $ $  ##
######  ############ ####  ##
####################  #######
###   ##    ##  ##### #######
### # #  ##  #  #####  #  ###
### $.*  ##$.#$.###   $*$   #
### .$ * # $.$ .  # # .$. # #
####*#$. #  .#$.$ # #$...$# #
##  .$.$ ##$.  .$## # .$. # #
## #$.$. ## $*.  ##   *$*   #
##    #  ###   ###  #  #  ###
#######   ##       ##########
######### ###################
#######   ############   ####
####  #  #######    ##   ####
#### $$$ ##   #  ##  $$$$$ ##
####.....##  $*$ ##   . .  ##
##  #$.$##   .$. #####.#.####
##   $. ## ##.  ######*..  ##
## $  .    # . .  ####.#.# ##
#####$.$  ## $*$  ##  . .   #
#####  ####   #   ## $$$$$  #
########### ##########   ####
########@   ##########   ####
#############################