       #####
     ###   #
#### #  $$ ####
#  ###  $  #  #
#    ###$$  $ #
# *#  @  ## # #
## ##### #..# ##
 #    ## #..#  #
 ##  $ # #..   #
# ## $ #  ..####
 # ##    #  #
  # ####   ##
   #   #####