   ####
   #  ###
####$.  #
#   * . #
#@#.#$# #
# $ *   #
#  .$####
###  #
  ####