###############
#  ..  .   .  #
# $##$ # $$##.#
#  #  ###  #  #
#.##  # # ##$ #
# $   $ $   $ #
#.##  # #  #  #
#.##  #@# ###.#
# $ # ### # #.#
# $         $ #
#.### ### # # #
#  #  #   ###.#
# $#$$###$# # #
#  .   .  . . #
###############