 ### # #### ##### #### # ###
############# @ #############
##  .     .   #     .$.    ##
## .$.$$$.$. ###.$  $.$  $.##
 #.$$$.*.$$$.# #$.*** ***.$#
## .$.$$$.$. ###.$  $.$  $.##
#   .     .   #     .$.     #
# ######################### #
#   $.   .$   #  $       .  #
##  * .$. *  ### .**   **$ ##
 #  $.$*$.$  # # *  ***  * #
##  * .$. *  ### $**   **. ##
 #  $.   .$   #  .       $ #
############# # #############
##            #            ##
##$.$  .$.$.$.#**.**$$$*.**##
##.$.$.$.$.$.$#  $. ..$.$  ##
 #$.$.$.$.$.$.#  $.$.. .$  #
##.$.$.$.  $.$#**.*$$$**.**##
#             #             #
# ######################### #
#    ..  ..   # . $ .$ . $  #
## $*$*$$$$*$ #  . .$.$ $  ##
 # *. .. .$.$ #$.$.$  .$.$.#
## $.$. .. .* #.$.$.  $.$.$##
## $*$$$$*$*$ #  $ $.$. .  ##
##   ..  ..   # $ . $. $ . ##
############# # #############
 #   .   .    #      .     #
## $$*$$$*$$ ### .$ $$$.$. ##
 #.....*.....# #*$.$...*.$*#
## $$*$$$*$$ ### .$.$$$ $. ##
#    .   .    #      .      #
# ######################### #
#   .  .  .   #   . . . .   #
## $$* $$* $ ### $.$.$.$.$ ##
 #.*.* * *.*.# #*$$$ * $$$*#
## $ *$$ *$$ ### $.$.$.$.$ ##
##  .  .  .   #   . . . .  ##
#############   #############
 ### # #### ##### #### # ###