   ## ##
 ##  #  ##
 ##     ##
#  *$#$*  #
#  $...$  #
 # #.@.# #
#  $...$  #
#  *$#$*  #
 ##     ##
 ##  #  ##
   ## ##