       ###
     ##   ##
   ##   $   ##
  #  $.#*#.$  #
  # #.$ . $.# #
 # $.  # #  .$ #
 # .$ $.*.$ $. #
#  # #.$ $.# #  #
# $*. * @ * .*$ #
#  # #.$ $.# #  #
 # .$ $.*.$ $. #
 # $.  # #  .$ #
  # #.$ . $.# #
  #  $.#*#.$  #
   ##   $   ##
     ##   ##
       ###