        ###
      ##   ##
    ## $ #$$ ##
   #  * . .#   #
  #  #$# . .$$  #
  # $ * .$# . # #
 #  $.#.#.$.#*$* #
 #$#. .$.$ $. # $#
# $. #$    .#. .  #
# # .$.$ @ $.$. # #
#  . .#.    $# .$ #
 #$ # .$ $.$. .#$#
 # *$*#.$.#.#.$  #
  # # . #$. * $ #
  #  $$. . #$#  #
   #   #. . *  #
    ## $$# $ ##
      ##   ##
        ###