      #
  #########
 ###  .   ##
 # $ *@.$$##
 # $. #$.  #
 # .$ #  * #
##. ## ## .##
 # *  # $. #
 #  .$# .$ #
 ##$$. * $ #
 ##   .  ###
  #########
      #