            #####
 ############ @ ############
 #            #            #
 #$.$  .$.$.$.#**.**$$$*.**#
 #.$.$.$.$.$.$#  $. ..$.$  #
 #$.$.$.$.$.$.#  $.$.. .$  #
##.$.$.$.  $.$#**.*$$$**.**##
#             #             #
# ######################### #
#    ..  ..   # $ . $. $ .  #
## $*$*$$$$*$ #  $ $.$. .  ##
 # *. .. .$.$ #.$.$.  $.$.$#
 # $.$. .. .* #$.$.$  .$.$.#
 # $*$$$$*$*$ #  . .$.$ $  #
 #   ..  ..   # . $ .$ . $ #
 ############ * ############
            #####