       ####
       #  ##
      ## $####
     ###. .  #
  #### $ # $ #
  #  #  . .####
 ## $####$ #  ##
###. . $. $# $####
# $ # $ **.#. .  #
#  . .#.** $ # $ #
####$ #$ .$ . .###
  ##  # $####$ ##
   ####. .  #  #
    # $ # $ ####
    #  . .###
    ####$ ##
      ## @#
       ####