 ### ### ###
##  # @ #  ##
#  $#$ $#$  #
# . . . . . #
 ##$#$ $#$##
# . . . . . #
#  $ $#$ $  #
# . . . . . #
 ##$#$ $#$##
# . . . . . #
#  $#$ $#$  #
##  #   #  ##
 ### ### ###