#####     #####
#   #######   #
# # #     # # #
#  $.$.$.$.$  #
###.$.$.$.$.###
 # $.$ . $.$ #
 # .$     $. #
 # $.*.+.*.$ #
 # .$     $. #
 # $.$ * $.$ #
###.$.$.$.$.###
#  $.$.$.$.$  #
# # #     # # #
#   #######   #
#####     #####