           #######
           #     #
          # * * * #
 ####   ## $ * * $ #
 #  #   # * * . * * #
##.$#####  *  #  *  #
#     @   * .# #. * #
#   #####  *  #  *  #
#####   # * * . * * #
        ## $ * * $ ##
          # * * * #
           #     #
           #######