           #####
 ########### @ ###########
 #   .   .   #     .     #
 # $$*$$$*$$ # .$ $$$.$. #
 #.....*.....#*$.$...*.$*#
## $$*$$$*$$ # .$.$$$ $. ##
#    .   .   #     .      #
# ####################### #
#   .  .  .  #  . . . .   #
## $$* $$* $ # $.$.$.$.$ ##
 #.*.* * *.*.#*$$$ * $$$*#
 # $ *$$ *$$ # $.$.$.$.$ #
 #  .  .  .  #  . . . .  #
 ########### * ###########
           #####