 ########
##  @   ##
# #$.$.# #
# $.$.$. #
# .$  .$ #
# $.  $. #
# .$.$.$ #
# #.$.$# #
##      ##
 ########