     ####
 #####  #
 #      #
 # ###  #
##$* # ##
# *..#  #
#   $$$ #
##*. $ ##
# $*.  #
#  . ###
## . #
 # @##
 ####