 ##### #
##   ####
## . ## ##
# $ *    ##
#  * * #  ##
### * * #  ##
 ##  *@*  ##
##  # * * ###
 ##  # * *  #
  ##    * $ #
   ## ## . ##
    ####   ##
     # #####