  ########
  #. #   #
  #.$    ##########
  #.$###.#  @ #   #
  #.$ # $$$ # # $ #
  # $ #..#  #   * #
  ##  #  #  # ..*##
   #*   .$ ##   * #
   #  #  ###### $ #
  ### ##      #   #
### $$ ##$.$.*#####
# ... .# .$.*  # #
#   $$ # $.* $   #
# # #  ###  #  # #
#   #### # ##### #
#####    #       #
         #########