      #####
     ###  ##
    ## $   ##
   ## $  *$ ##
  ## $.#.$.$ ##
 ## $.$. .$.$ ##
## $.$. . .$.$ ##
#  *$. * * .# $##
#   . . @ . .   #
##$ #. * * .$*  #
## $.$. . .$.$ ##
 ## $.$. .$.$ ##
  ## $.$.#.$ ##
   ## $*  $ ##
    ##   $ ##
     ##  ###
      #####