   ##########
  ##        #
 ##    ###  #######
 # $$ #    $#  #  #
 #  ###  #$$      #
 #    $$ #     #$$#
 #  #   #### #$   #
 ## # ###.*. # ## #
## *.*.#..*.##    ###
#  ***...**.### $$  #
# #....#...#  #   # #
#  ## ##.*. $ # ### #
##  # $ ..##   $  # #
 ## # $$### $#$$  # #
  #  @  #   $    #  #
  #####   ##$####  ##
      ######      ##
           ########