   #######
  ##     #
### .### #
# $ $  # #
#@*.$..  #
# $ $  ###
### #. #
  #   ##
  #####