          #
         # #
        # . #
       # $.$ #
      #  .$.  #
     # $.$ $.$ #
    # $. . . .$ #
   # $.$.$ $.$.$ #
  #  . . # # . .  #
 # $.$.$# $ #$.$.$ #
# ..$    $@$    $.. #
 # $.$.$# $ #$.$.$ #
  #  . . # # . .  #
   # $.$.$ $.$.$ #
    # $. . . .$ #
     # $.$ $.$ #
      #  .$.  #
       # $.$ #
        # . #
         # #
          #