  #########
  #   #   #
### # # # ###
#  * * $ *  #
# # . . . # #
#  $ *$* *  #
### .$@$. ###
#  * *$* $  #
# # . . . # #
#  * $ * *  #
### # # # ###
  #   #   #
  #########