#############
#.    #    .#
# $  $#$  $ #
#  *** ***  #
#  * . . *  #
# $*.***.*$ #
###  *@*  ###
# $*.***.*$ #
#  * . . *  #
#  *** ***  #
# $  $#$  $ #
#.    #    .#
#############