     ####
     #  #
  ####$ #
### . . ###
# $* +$*  #
#  . . .# #
## $# $$  #
 ##   #  ##
  ########