  #########################
  #           #           #
###$$ $$ $$ $$.$$ $$ $$ $$###
# $+.$..$..$..$..$..$..$..$ #
# $..$..$..$..$..$..$..$..$ #
#  $$.$$.$$.$$.$$.$$.$$.$$  #
# $..$..$..$..$..$..$..$..$ #
# $..$..$..$..$..$..$..$..$ #
##.$$.$$.$$.$$ $$.$$.$$.$$.##
# $..$..$..$..$..$..$..$..$ #
# $..$..$..$..$..$..$..$..$ #
#  $$.$$.$$.$$.$$.$$.$$.$$  #
# $..$..$..$..$..$..$..$..$ #
# $..$..$..$..$..$..$..$..$ #
###$$ $$ $$ $$.$$ $$ $$ $$###
  #           #           #
  #########################