####  ####  #  ####  ####
#  ####  #######  ####  #
# .$. # .$. # .$. # .$. #
#. $ . . $ . . $ . . $ .#
#$$#$$*$$#$$@$$#$$*$$#$$#
#. $ . . $ . . $ . . $ .#
# .$. # .$. # .$. # .$. #
#  ####  #######  ####  #
####  ####  #  ####  ####