           #
    #     # #
   # #  ##   ##
  # . # # .$. #
 # $.$ # .$ $. #
#   *  @ $ * $  #
 # $.$ # .$ $. #
  # . # # .$. #
   # #  ##   ##
    #     # #
           #