#####     ######
#   #     #    #
# # ####### ##@#
#  $$ $ $ $ $  #
### . .... .$###
  #$ ######  #
  # .#    #.$#
  #$.# ## #. #
  # .# ## #.$#
  #$.#    #. #
  #  ###### $#
###$. .... . ###
#  $ $ $ $ $$  #
# # ######## # #
#   #      #   #
#####      #####