#################
#  .    .    .  #
# ##$###$###$## #############
#.##  ##  ## ##.#  .     .  #
# $   *   *   $ # ##$###$## #
# ##  #   #   # #.##  ## ##.#
# ##*###*###*## # $   *   $ #
# #   #   #  ## # ##  #   # #
#.$   *   *   $.@ ##*###*## #
# ##  #   #   # # #   #  ## #
# ##*###*###*## # $   *   $ #
# #   #   #  ## #.## ##  ##.#
# $   *   *   $ # ##$###$## #
#.## ##  ##  ##.#  .     .  #
# ##$###$###$## #############
#  .    .    .  #
#################