       ####
     ###  #
     ##   #
  ####  $ #
  #  # .$###
 ## *$* * #
## + . .  #
#   . *$* #
# $*$. #  #
#  #  #####
########
   #