#################################
###                           ###
###.$.$.$.$.$.$.$.$.$.$.$.$.$.###
# . .$.$.$.$.$.$.$.$.$.$.$.$. . #
# $.$.$.$.$.$.$.$.$.$.$.$.$.$.$ #
# .$.$.$.$.$.$.$.$.$.$.$.$.$.$. #
# $.$.$.$.$.$.$.$.$.$.$.$.$.$.$ #
# .$.$.$.$.$.$.$.$.$.$.$.$.$.$. #
# $.$.$.$.$.$.$.$.$.$.$.$.$.$.$ #
# .$.$.$.$.$.$.$.$.$.$.$.$.$.$. #
# $.$.$.$.$.$.$.$.$.$.$.$.$.$.$ #
# .$.$.$.$.$.$.$.$.$.$.$.$.$.$. #
# $.$.$.$.$.$.$.$.$.$.$.$.$.$.$ #
# .$.$.$.$.$.$.$.$.$.$.$.$.$.$. #
# $.$.$.$.$.$.$ $ $.$.$.$.$.$.$ #
# .$.$.$.$.$.$     $.$.$.$.$.$. #
# $.$.$.$.$.$.$ @ $.$.$.$.$.$.$ #
# .$.$.$.$.$.$     $.$.$.$.$.$. #
# $.$.$.$.$.$.$ $ $.$.$.$.$.$.$ #
# .$.$.$.$.$.$.$.$.$.$.$.$.$.$. #
# $.$.$.$.$.$.$.$.$.$.$.$.$.$.$ #
# .$.$.$.$.$.$.$.$.$.$.$.$.$.$. #
# $.$.$.$.$.$.$.$.$.$.$.$.$.$.$ #
# .$.$.$.$.$.$.$.$.$.$.$.$.$.$. #
# $.$.$.$.$.$.$.$.$.$.$.$.$.$.$ #
# .$.$.$.$.$.$.$.$.$.$.$.$.$.$. #
# $.$.$.$.$.$.$.$.$.$.$.$.$.$.$ #
# .$.$.$.$.$.$.$.$.$.$.$.$.$.$. #
# $.$.$.$.$.$.$.$.$.$.$.$.$.$.$ #
# . .$.$.$.$.$.$.$.$.$.$.$.$. . #
###.$.$.$.$.$.$.$.$.$.$.$.$.$.###
###                           ###
#################################