                #####
          #######   # #####
     ######       #.###   #
    ##      # ### #.    * #
    #  ###### ##  #  ### ##
    # ## $ ..$ # $   ##  #
    # #  $ *.$@##### #  ##
    # #    ..$ # $   # ##
#####$#######$## # .   #
# $            . #### ####
# $$# #########$##   .   #
# # . .#      .  # $$*$$ #
#   .  # $.$.#   #... ...#
##### $ # ## ##### $$*$$ #
    #.#    #         .   #
    ######################