 #########################
 #  #  #  #  #  #  #  #  #
 # $#$ # $#$ # $#$ # $#$ #
 #  #  #  #  #  #  #  #  #
 # $#$ # $#$ # $#$ # $#$ #
 #  #  #  #  #  #  #  #  #
 ## # ### # ### # ### # ##
 #  #  #  #  #  #  #  #  #
 #  $  #  $  #  $  #  $  #
## ### # ### # ### # ### ##
#   #  #  #  #  #  #  #   #
#   #  $  #  $  #  $  #   #
##  # ### # ### # ### #  ##
 #...........+...........#
 #########   #   #########
         #  ###  #
         #### ####