  ####
  #  # #####
  #$.#
###  ########
#           #
# #.***..*#.###
# $$$  @  $$$ #
###.##### #.# #
  #           #
  ########  ###
         ####