   #####
   ##  #  ####
 ###   ####  #
 #  .*$ ##   ###
 #  *.$ #  *. ##
 ##   # #  .*  #
  ##  # ###$$  #
  #####@     ###
###      #####
#  $$### #  ##
#  *.  # #   ##
## .*  # $.*  #
###   ## $*.  #
  #  ####   ###
  ####  #  ##
        #####