  #########################
  #                       #
### # # # # # # # # # # # ###
#  $.$.$.$.$.$.$.$.$.$.$.$  #
# #.$.$.$.$.$.$.$.$.$.$.$.# #
#  $.$.$.$.$.$.$.$.$.$.$.$  #
# #.$.$.$.$.$.$.$.$.$.$.$.# #
#  $.$.$.$.$.$.$.$.$.$.$.$  #
# #.$.$.$.$.$.$.$.$.$.$.$.# #
#  $.$.$.$.$.$.$.$.$.$.$.$  #
# #.$.$.$.$.$.$.$.$.$.$.$.# #
#  $.$.$.$.# # # #.$.$.$.$  #
# #.$.$.$.$       $.$.$.$.# #
#  $.$.$.$.# # # #.$.$.$.$  #
# #.$.$.$.$   @   $.$.$.$.# #
#  $.$.$.$.# # # #.$.$.$.$  #
# #.$.$.$.$       $.$.$.$.# #
#  $.$.$.$.# # # #.$.$.$.$  #
# #.$.$.$.$.$.$.$.$.$.$.$.# #
#  $.$.$.$.$.$.$.$.$.$.$.$  #
# #.$.$.$.$.$.$.$.$.$.$.$.# #
#  $.$.$.$.$.$.$.$.$.$.$.$  #
# #.$.$.$.$.$.$.$.$.$.$.$.# #
#  $.$.$.$.$.$.$.$.$.$.$.$  #
# #.$.$.$.$.$.$.$.$.$.$.$.# #
#  $.$.$.$.$.$.$.$.$.$.$.$  #
### # # # # # # # # # # # ###
  #                       #
  #########################