          ######
          #    #
########### ## #
#   $. $  $  # #
# # $..*.+*. # #
#   $. $  $  # #
####### ## ### #
      #  #    *#
      ## ##### #
       #       #
       #########