           #
          # #
         # # #
        #  #  #
       #   #   #
      #    $    #
     #.*********.#
    # *         * #
   #  * ******* *  #
  #   * *     * *   #
 #    * * *** * *    #
# ###$* * *@* * *$### #
 #    * * *** * *    #
  #   * *     * *   #
   #  * ******* *  #
    # *         * #
     #.*********.#
      #    $    #
       #   #   #
        #  #  #
         # # #
          # #
           #