 #####
##   ## ####
#  #  # #  #
# *$* ###$ ##
# .$. ... $ ##
# *$* ###    ##
#  #  # #    @#
##   ## #######
 #####