###################
# $.$.  *.$ * $.  #
# .$ * $.*  .$.$  #
#@$.$. .$ * * $. ##
# .$ * * $. .$.$ #
# $.$.  *.$ * $. #
# .$ * $.*  .$.$ #
##################