    #####
#####   #
#       #
#$ $ $ $#
#.*.*.*.#
#$ $ $ $#
#.*.*.*.#
#       #
#.*.*.*.#
#$ $ $ $#
#.*.*.*.#
#$ $ $ $#
#       #
#@ ######
####