##########
#   #    #
# #$$$$$ #
#  .#.#  #
#  ...  ##
### @ ###
  #####