    ####
  ###  #
 ## .  #
##     #
# .$. ##
# $ ###
# .$####
###    #
  # $  #
  ### ##
  ###  #
 ## .  #
##  *  #
# .$ ###
# *.##
#  $####
###    #
 ##$#  #
 #  #  #
 #  @ ##
 ###  #
   ####