 ####### ####
 #  #  ###  ###
##.$#  . # .. #
# .$   $ # $$ #
#   ## #### ###
###### . ##   #
 #  # *$*     #
##.$#.$@$.#$.##
#     *$* #  #
#   ## . ######
### #### ##   #
# $$ # $   $. #
# .. # .  #$.##
###  ###  #  #
  #### #######