   ########
  ###     #
#### $* .$##
# $ $.# . ###
# ..# # #$ ##
#    * * .$ #
# *## # ##* #
# $. * *    #
## $# # #.. #
### . #.$ $ #
 ##$. *$ ####
  #  @  ###
  ########