        #
       # #
      # . #
     #  $  #
    #  *.*  #
   #  *.$.*  #
  #  *.$ $.*  #
 #  *.$ $ $.*  #
# .$.$ $@$ $.$. #
 #  *.$ $ $.*  #
  #  *.$ $.*  #
   #  *.$.*  #
    #  *.*  #
     #  $  #
      # . #
       # #
        #