      #  ###  #
 ###################
 # ... ..   .. ... #
 #.$$$$$$*$*$$$$$$.#
 #.$  . . . . .  $.#
 #.$ *$*$*$*$*$* $.#
## $.$. . . . .$.$ ##
 #.$ * *$*$*$* * $.#
 #.$.$.$. . .$.$.$.#
## * * * *$* * * * ##
## $.$.$.$@$.$.$.$ ##
## * * * *$* * * * ##
 #.$.$.$. . .$.$.$.#
 #.$ * *$*$*$* * $.#
## $.$. . . . .$.$ ##
 #.$ *$*$*$*$*$* $.#
 #.$  . . . . .  $.#
 #.$$$$$$*$*$$$$$$.#
 # ... ..   .. ... #
 ###################
      #  ###  #