     #######
     #  #  #
  ####. $* #
  #   $*  .#
  ###  #*  #
  ## $* $.##
  ##   .@ #
  ###*#  ##
####  #####
#   .  #
# $* $.####
##  #*    #
## $*  .###
###. $* ###
  #  #    #
  #########