     ####
   ###  #
####    #
#  .$.$.##
#  $.$.$ #
## .$@$. ##
 # $.$.$  #
 ##.$.$.  #
  #    ####
  #  ###
  ####