     #####
  ####   #
  #   $  #
###  #$###
#  * .  #
# * * #@#
#  * *  #
### * .##
  ##   #
   #####