 ###############
 #.  $  .  $  .#
 # ##$# # #$## #
 #  .* .#. *.  #
 # #   *$*   # #
##$$*   #   *$$##
#  #. $. .$ .#  #
#@   #* * *#    #
#  #. $. .$ .#  #
##$$*   #   *$$##
 # #   *$*   # #
 #  .* .#. *.  #
 # ##$# # #$## #
 #.  $  .  $  .#
 ###############