       ######
       ##  ##
       ##  ##
      ### .###
     ##.$.$  ##
    ##.$.$*   ###
   ##.$.$*  *$ ##
  ##.$.$*  *$.$.#
###.$.$*  *$.$.##
##.$.$*  *$.$.###
#.$.$*  *$.$.##
## $*  *$.$.##
###   *$.$.##
  ##@ $.$.##
   ###. ###
    ##  ##
    ##  ##
    ######