     ####
######  #
##  * * #
#  .$.$ #
#   * *@#
#  .$.$ #
##  * * #
 ##  #  #
  #######