 ###########
 #         #
##.#.$.#.#$###
# $.$#$. .   #
# .$. . .#$#@#
# $.#*#.#  $ #
#  #  $ $   ##
# $$   ######
#  #####
####