#  ###
 ##   ##
 #*.$  #
# .$.$ .##
# $.$.$  #
#  $.@.$  #
 #  $.$.$ #
 ##. $.$. #
   #  $.*#
   ##   ##
     ###  #