     ###
   ##   ##
  #   #   #
 # # ..* # #
 #   $*$   #
#  *$# #$.  #
# #.* @ *.# #
#  .$# #$*  #
 #   $*$   #
 # # *.. # #
  #   #   #
   ##   ##
     ###