   ####
 ###  ##
 # $$. ###
 # .$.$$ #
 ##  . . #
### @# ###
# . .  ##
# $$.$. #
### .$$ #
  ##  ###
   ####