 ####                   ####
 #  #####################  #
 #    ....... @ .......    #
 #  # .###############. #  #
###  #.    #  #   #   .#  ###
 #     #   $  #   $  #     #
 #     ##$##  ##$##  #     #
 ###   #  ##$##  #####   ###
 #  #  #  $   $  $   #  #  #
 #     #  #   #  #   #     #
 #  #  #####$######$##  #  #
 ##   ##   #  #   #  ##   ##
 #######   $  #   $  #######
       ##$##  ##$##  #
###### #  #####  ##$## ######
#    # #  $   $  $   # #    #
###### #  #   #  #   # ######
       ###############