  ######
 ## #  ###
## #   # ##
# #   $.# #
##  $ $.# #
# #####. ##
#     $*  ###
#     $. ## #
### # #.##  ##
  #### .#    #
    # $.$   ##
   ## $.#  ##
  ##  #.$ ##
 ##   $.$ #
 #    #. ####
 ##  ##.# # ###
  # ## .$     #
  ###@ *$     #
    ## .##### #
    # #.$ $  ##
    # #.$   # #
    ## #   # ##
     ###  # ##
       ######