    ####
 ####  ##
 #  # *###
##.$#  * ##
#   @ * * ##
#   #  * * ##
##### * * * ##
    ## * * * ##
    ##  * * * ##
     ##  * * * ##
      ##  * * * #
       ##  * *  #
        ##  * * #
         ##  * ##
          ##   #
           ##  #
            ####