######
##  ##
## $######
#  @ #  ##
# . *#$.##
### * $. #
  #      #
  ########