      # # #
 ###############
 # ... . . ... #
 #.$$$$$*$$$$$.#
 #.$.  . .  .$.#
 #.$ $*$*$*$ $.#
## $ * . . * $ ##
 #.$.$.$*$.$.$.#
## * * *@* * * ##
 #.$.$.$*$.$.$.#
## $ * . . * $ ##
 #.$ $*$*$*$ $.#
 #.$.  . .  .$.#
 #.$$$$$*$$$$$.#
 # ... . . ... #
 ###############
      # # #