     #####
  ####   ###
  #    #   ###
 ## #  $.#   #
 #  $.#.$.$# #
## #.$.$ $.  ##
#  .$ $.$.#   #
# #$.$.@.$.$# #
#   #.$.$ $.  #
##  .$ $.$.# ##
 # #$.$.#.$  #
 #   #.$  # ##
 ###   #    #
   ###   ####
     #####