       ####
      ##  ##
      # $  ##
  #####  *  #
 ##  .  * * #
##  * * $* .#
#  * *$..$* ###
# $ *$.##.    ##
##    .##.$* $ #
 ### *$..$* *  #
   #. *$ * *  ##
   # * *@ .  ##
   #  *  #####
   ##  $ #
    ##  ##
     ####