  ######
  ##   ###########
  # $ $  $  # *  ######
  # .*.#..*.# .$     ##
  # *  # $ $  * $#*.$ #
 ## ####    # .  # *  #
 #  $ #########.## .$ #
 #.*.. *        #### ##
 #$ $ #$#.$$.*# #    #
 #    # #*.$$.#$# $ $#
## ####        * ..*.#
# $. ##.######### $  #
#  * #  . #    #### ##
# $.*#$ *  $ $ # .$ #
##     $. #.*..# * @#
######  * #  $  *.$ #
     ###########   ##
               ######