   ######
   #    #
#### #  #
#  .$.$.###
#  $.$.$  #
# #.$@$.# #
#  $.$.$  #
###.$.$.  #
  #  # ####
  #    #
  ######