    #########
   #    .    #
  #  ### ###  #
 #  #   .   #  #
 # #  ##.##  # #
 # # #  .  # # ##
## # # # # # #  #
# $$*$$ @ $$*$$ #
#  # # # # # # ##
## # #  .  # # #
 # #  ##.##  # #
 #  #   .   #  #
  #  ### ###  #
   #    .    #
    #########