        #####
        #   #####
      ###$$ @   #####
   ####.. $ #$$$  $ #####
   # $ ..##..   # $     #
   # $ #   ..##.. $ #$$$#
   # $ #$$$# $ ..##..   ##
  ## #..   # $ #   ..##..#
  #   ..##.. $ #$$$# $ ..###
  #$$$# $ ..##..   # $ # $ #
  #   # $ #   ..##.. $ #$$ #
 ## #.. $ #$$$# $ ..##..   #
 # $ ..##..   # $ #   ..# ##
 # $ #   ..##** $ #$$$# $ #
 # $ #$$$# $ **##..   # $ #
## #..   # $ #   ..##.. $ #
#   ..##.. $ #$$$# $ ..# ##
# $$# $ ..##..   # $ #   #
# $ # $ #   ..##.. $ #$$$#
###.. $ #$$$# $ ..##..   #
  #..##..   # $ #   ..# ##
  ##   ..##.. $ #$$$# $ #
   #$$$# $ ..##..   # $ #
   #     $ #   ..##.. $ #
   ##### $  $$$# $ ..####
       #####     $$###
           #####   #
               #####