          #########
     #### #       #
  ####  # # $     #
  #  #  ####.#    #
  #   $ $   .#### #
  #  $#$## #.#....#
### # $  # #.#....#
#  $ $  # #..*....#
# # ## $  # ####  #
#  $ # # $#      ##
##  $  #    ######
 ##  $ # $$$#
  ## $$@##  #
   ##      ##
    ########