      #
    ## ##
    #   #
   # .$. #
 ##  $.$  ##
 # .$.$.$. #
#  $.$+$.$  #
 # .$.$.$. #
 ##  $.$$ ##
   # .$.    #
    #   # # #
    ## ##   #
      #  ###