#############
#@  #   #   #
# # # # # # #
#   #  *$*  #
# #####. .###
#   #  *$.  #
# #$# # #$# #
#  .$*      #
###. .##### #
#  *$*  #   #
# # # # # # #
#       #   #
#############