#####       ###
#  ###############
# $   * @ *  #   #
#  # * * * *     #
## #  * . *  # ###
 # # * * * * # #
 # #  * . *  # #
 # # * * * * # #
## #  * . *  # ##
## ###########  #
# $           $ #
#   ##########  #
#####       #####