    #######
    ## # ##
    #     #
    ##$.$##
#####  .  #####
## # #$ $# # ##
#  $ $...$ $  #
## .. .@. .. ##
#  $ $...$ $  #
## # #$ $# # ##
#####  .  #####
    ##$.$##
    #     #
    ## # ##
    #######