         #
    #  #####
  #####    ####
  #   ..$$ #  #
  # $ $ .#@#$ ##
 #### # *##   #
 #   #  *  #$.#
## $##  .    . #
 # $.**.#.**.$ #
 # .    .  ##$ ##
  #.$#  *  #   #
  #   ##* # ####
 ## $# #. $ $ #
  #  # $$..   #
  ####    #####
     #####  #
       #