            #########
            #  * *  #
            #       #
           ### # # ###
           # $ # # $ #
           # $ # # $ #
           #  ## ##  #
          ### #   # ###
        # # $ ## ## $ # #
          # $  # #  $ #
       ####   ## ##   ####
   #####   #.##   ##.#   #####
####   #$$ .  #   #  . $$#   ####
#  #$$     #  .. ..  #     $$#  #
#     ### ###. .#. .### ###     #
#* #### ###  ..   ..  ### #### *#
#             # @ #             #
#* #### ###  ..   ..  ### #### *#
#     ### ###. .#. .### ###     #
#  #$$     #  .. ..  #     $$#  #
####   #$$ .  #   #  . $$#   ####
   #####   #.##   ##.#   #####
       ####   ## ##   ####
          # $  # #  $ #
        # # $ ## ## $ # #
          ### #   # ###
           #  ## ##  #
           # $ # # $ #
           # $ # # $ #
           ### # # ###
            #       #
            #  * *  #
            #########