   ###########
  #           #
 ##$####.####$##
# $. $ $.$ $ .$ #
# # ...   ... # #
# #$.$ $.$ $.$# #
# # . *#.#* . # #
# #$ $# $ #$ $# #
# .. ..$@$.. .. #
# #$ $# $ #$ $# #
# # . *#.#* . # #
# #$.$ $.$ $.$# #
# # ...   ... # #
# $. $ $.$ $ .$ #
 ##$####.####$##
  #           #
   ###########