      ####
      #  #
#######$ #
# . $ $  #
#  . .. ##
##$##+#$#
 # . .. ####
##. $ $  $ #
#  #####   #
# $#   #####
#  #
####