        ####
#########  #
#          #
# #*### #  #
#  $   # # #
#*#*##  #  #
#  $  #  # #
#  *#  # # #
#  $ # # # ##
###$. . . . #
  #@####### #
  #         #
  ###########