         ##### # #####
        ## # ##### # ##
        #  #   #   #  #
       ## $* $   $ *$ ##
       #   ..*# #*..   #
       ###*..  #  ..*###
        # $ *$ # $* $ #
  ##### #   # .$. #   #
 ## # #### ###$ $### ###
 #  #   #   # .$. #   #
## $* $   $ *$ # $* $ #
#   ..*# #*..  #  ..*###
###*..  #  ..*# #*..  @#
 # $ *$ # $* $   $ *$ ##
 #   # .$. #   #   #  #
### ###$ $### #### # ##
 #   # .$. #   # #####
 # $ *$ # $* $ #
###*..  #  ..*###
#   ..*# #*..   #
## $* $   $ *$ ##
 #  #   #   #  #
 ## # ##### # ##
  ##### # #####