    #####
    #  ##
    # $##
    #  ##
##### *######
#####. .    #
# $ * @ * $ #
#    . .#####
######* #####
    ##  #
    ##$ #
    ##  #
    #####