       ######
       ###  #
       # .. #
       # $$ #
       ### ##
         # #
      #### ####
      ###    ## #####
##### #    * ## #  ##
#   ### ****  ###$.##
# .$     *@*     $. #
##.$###  **** ###   #
##  # ## *    # #####
##### ##    ###
      #### ####
         # #
        ## ###
        # $$ #
        # .. #
        #  ###
        ######