################
#  . * . .$    #
#@ $.$. * *.*. #
## $ $  $ $ # ###
 ##### #### #  #
     #   ## ## ##
     ### # * $. #
      #  #      #
     ## ## ######
     # * $. #
     #      #
     ########