  ##### # #####
 ## # ##### # ##
 #  #   #   #  #
## $* $   $ *$ ##
#   ..*# #*..   #
###*..  #  ..*###
 # $ *$ # $* $ #
 #   #  *  #   #
### ###* *### ###
 #   #  *  #   #
 # $ *$ # $* $ #
###*..  #  ..*###
#   ..*#@#*..   #
## $* $   $ *$ ##
 #  #   #   #  #
 ## # ##### # ##
  ##### # #####