########
##  ####
##. #  #
#  *$$ ######
#  $.      ##
#####*###. ##
  #   * *   #
  # #.$@$.# #
  #   * *   #
  ## .###*#####
  ##      .$  #
  ###### $$*  #
       #  # .##
       ####  ##
       ########