  ####
  #  ###
### .  ##
#   .#  #
# $$*$$ #
### .  ##
  # . @#
  ######