          #
         # #
        # # #
       #  *  #
      # * $ * #
     #  # $ #  #
    #   # # #   #
   #   .* . *.   #
  # *##*  #  *##* #
 #       * *       #
# #*$$#.# @ #.#$$*# #
 #       * *       #
  # *##*  #  *##* #
   #   .* . *.   #
    #   # # #   #
     #  # $ #  #
      # * $ * #
       #  *  #
        # # #
         # #
          #