       #    #    #    #
  ##########################
 ##    #    #    #    #    ##
 # $.$.#.$.$#$.$.#.$.$#$.$. #
 # .$.$ $.$. .$.$ $.$. .$.$ #
 # $.$. .$.$ $.$. .$.$ $.$. #
 # .$.$#$.$. .$.$#$.$. .$.$ #
####   #   ###   #   ###  ####
 # .$.$#$.$. .$.$#$.$. .$.$ #
 # $.$. .$.$ $.$. .$.$ $.$. #
 # .$.$ $.$. .$.$ $.$. .$.$ #
 # $.$. .$.$#$.$. .$.$#$.$. #
####  ###   #   ###   #   ####
 # $.$. .$.$#$.$. .$.$#$.$. #
 # .$.$ $.$. . @$ $.$. .$.$ #
 # $.$. .$.$ $  . .$.$ $.$. #
 # .$.$#$.$. .$.$#$.$. .$.$ #
####   #   ###   #   ###   ###
 # .$.$#$.$. .$.$#$.$. .$.$ #
 # $.$. .$.$ $.$. .$.$ $.$. #
 # .$.$ $.$. .$.$ $.$. .$.$ #
 # $.$. .$.$#$.$. .$.$#$.$. #
####  ###   #   ###   #   ####
 # $.$. .$.$#$.$. .$.$#$.$. #
 # .$.$ $.$. .$.$ $.$. .$.$ #
 # $.$. .$.$ $.$. .$.$ $.$. #
 # .$.$#$.$.#.$.$#$.$.#.$.$ #
 ##    #    #    #    #    ##
  ##########################
       #    #    #    #