   ######  #####
  ##    ####   #
  #  ##  $   # #
  # # .# $# $  #
  # #$.$  #   #######
  #  $. # ### #     #
  ### .$. . # #.$.$ #
   # $. ###$#$# ## ##
####  #$        #   #
#   # $ ###@###.    #
# $     #  #..  #..##
###### #    ..# .  #
    #   $$ #..## ..#
    #  $ $##     # #
    # $$       #   #
    #  #############
    ####