  ######     ###########
 ##    #######. . . .  ##
##.$.$.$     .$.$.$.$.$.##
# $.$.$.#####$.$.$.$.$.$ #
# .$.$.$#   # $.$.$.$.$. #
#.$.$.  # $     ####.$.$ #
# .$.##### ### ##  # .$. #
#.$.$#   #  # $  $ # $.$##
# .$.# $  $ # # #  #### #
#.$.$## ##  #   # ##  # #
# .$. #   ###### $  $ # #
#.$.$  $# #    #   #  # #
##.$  #   # ## ##### ## #
 # ## ##### ## #   #  $.##
 # #  #   #    # #$  $.$.#
 # # $  $ ######   # .$. #
 # #  ## #   #  ## ##$.$.#
 # ####  # # # $  $ #.$. #
##$.$ # $  $ #  #   #$.$.#
# .$. #  ## ### #####.$. #
# $.$.####     $ #  .$.$.#
# .$.$.$.$.$ #   #$.$.$. #
# $.$.$.$.$.$#####.$.$.$ #
##.$.$.$.$.$.  @  $.$.$.##
 ##  . . . .#######    ##
  ###########     ######