   ####
   #@ #
  ##  ##
  # .$###
  #$. ####
### .$#  #
#  ..*.$ #
# $ $ #  #
##### # ###
    # #  #
    #    #
    ###  #
      ####