      #
     # #
    # @ #
   #  .  #
  # $*$*$ #
 #  * . *  #
#  .$.#.$.  #
 #  * . *  #
  # $*$*$ #
   #  .  #
    #   #
     # #
      #