##### #####
###########
##   .   ##
## .$.$. ##
## $*$*$ ##
 #..$@$..#
## $*$*$ ##
## .$.$. ##
##   .   ##
###########
##### #####