####
#  #       #####
#  #########   #
#   * * * *    #
##   * * *   ###
 #*   * *   *#
 # *   *   * #
 #* *  #  * *#
 # * *# #* * #
 #* *  #  * *#
 # *   *   * #
 #.   * *   *#
 #   * * *   ##
 #@ $ * * *   #
 ###########  #
           #  #
           ####