   ####   ####
   #  #####  ####
#### $ $        ##
#   $   ###  ##  ##
#@### # ###.#..#  #
#  $  # #      .# #
# $ # # #   #  .  #
## #  # ###########
 #   ## $ $ $ #
 ###### #.#.#.###
    #     # #   #
    # # #.#.#.# #
    # # $ $ $ # #
    #  #  # # # #
    ##  ###   # #
     ##    ###  #
      ####     ##
         #######