######
##  ##
## $#########
#  @ #  #  ##
# . *#$.#$.##
### * $. $. #
  #         #
  ###########