###### ######
#   #####   #
# #   #   # #
#  $.$.$.$  #
## .$.$.$. ##
## $.$.$.$ ##
 ##.$.@.$.##
## $.$.$.$ ##
## .$.$.$. ##
#  $.$.$.$  #
# #   #   # #
#   #####   #
###### ######