    #####
 ####   #
 # @ $# #
 # #....#
##$ $ $ #
#  ### ##
#      #
#####  #
    ####