                ####
              ###  #
              #    #
          ##### #* ##
          #  $  # ######
          # # $.#      #
        ### #$.$#*#### #
        ##  #.$.###  # #
       ##  ##$. #    # #
       ## ##   .  #* # #
      ##   # # #### ## #
      ## # $.  #  *  # #
#######   .##$## #     #
#     # ##$##.   #######
# #  *  #  .$ # ##
# ## #### # #  @##
# # *#  .   ## ##
# #    # .$##  ##
# #  ###.$.#  ##
# ####*#$.$# ###
#      #.$ # #
###### #  $  #
   ## *# #####
    #    #
    #  ###
    ####