#################
#@  #   #   #   #
# # # # # # # # ###
#  $.$.$.$.$.$.$. #
###.$.$.$.$.$.$.$ #
  #$.$.$.$.$.$.$. #
  # # # # # # # # #
  #   #   #   #   #
  #################