 ###########
##         #
#  #######$##
# #       $ ###
# #...***.*.@ #
# #       $ # #
#  #######$#  #
##        $  ##
 ########   ##
        #####