              ##############
#####         #    #   ##  #
#   ########### ## #    ...#
#..............  # ## ###  #
#.# ###@#### ##  #    #   ###
#.#   ###  #     ######     #
#.# #   $  ##          #    #
#.#  $ $ $ ####        #    #
#.#  $ # $ $  ####  ## ##   #
#  ## ##  $   $  #          #
#   $$ ##### $   ##      #  #
## $     $ #### $########   #
 #  $ $ $   $ ##  #     #  ##
 ########  $   $  # ### #  #
        ####  $   # #*# ####
           ####  ## ###
              ####