    #####
  ###   #
  #. @# #####
  #*#$  #   #
  #. $ #    ##
  # ###  * * #
  #   * * *  #
  #  * * *  ##
  # * . *   #
###* # ######
# $ *  #
#     ##
###  ##
  ####