#########
#   #   #
# # #   #
# .$..$##
#  $..$ #
###$#@# #
 # $.   #
 #   ####
 #####