  #####
 ##  #####
 ##  #   ##
 #  *$*.  #
## *.  *  #
###$ @ $###
#  *  .* ##
#  .*$*  #
##   #  ##
 #####  ##
    #####