 ###     ###
# ######### #
### .   . ###
##  $.$.$  ##
 #.*$$ $$*.#
##  $.$.$  ##
### . @ . ###
# ######### #
 ###     ###