 ################
##              ##
#  ############  #
# #            # #
# # $$$ $ $   @# #
#  #   ###   $$# ##
## $ ##   #   $ $ #
 ##   # #  ####   #
  ###..  #     #  ###
    ##    .. # .# $ ####
     # #### ## .# #.#  #
     #    # ###* $ .#  ##
     #### #    .# #.    #
        #   ## .###.##  #
        ######          #
             #   #  #   #
             ############