   #####
   #   ########
 ### #  . #   #
 #   # $# # # ###
 # ## . ..#$#   #
 #  $$# $  $ ## #
 #### # ####.   #
 #  . # $    $ ##
 #.#.$#.@.#$.#.#
## $    $ # .  #
#   .#### # ####
# ## $  $ #$$  #
#   #$#.. . ## #
### # # #$ #   #
  #   # .  # ###
  ########   #
         #####