##########
# ##  #  #
# # * ####
###$ .$ ##
#  . @ * #
# *   .  #
## $. $###
#### * # #
#  #  ## #
##########