 #########
###  @  ###
#   ***   #
# $ $.$ $ #
####. .####
  ## * ##
 ## * * ##
 # *   * #
 #  *$*  #
 # * . * #
 # *   * #
 #  *$*  #
 # * . * #
 ## * * ##
 ### . ###
   #   #
   #####