      #######
     ##     ##
     #  *.*  #
     # #$ $# #
 #####  *.*  #####
##   ##     ##   ##
#  #  ###.###  #  #
# *$* # $*$ # *$* #
# . . ..$@$.. . . #
# *$* # $*$ # *$* #
#  #  ###.###  #  #
##   ##     ##   ##
 #####  *.*  #####
     # #$ $# #
     #  *.*  #
     ##     ##
      #######