##################
#@ . * *. * * .  #
# .$  $ $  $ $ . #
#. **$. **$. **$.#
# $** .$** .$**  #
#*  $ *  $ .  $ *#
# $...$...*$*..$ #
#* $  * $  . $  *#
#  **$. **$. **$.#
#.$** .$** .$**  #
#*  $ .  $ *  $ *#
# $..*$*...$...$ #
#* $  . $  * $  *#
#  **$. **$. **$ #
#.$** .$** .$** .#
# . $ $  $ $  $. #
#  . * * .* * .  #
##################