      #####
      #   #######
      #    ##   ##
      #.#       ###
  #####.#  # #######
 ##  ##.####. ##   ##
##     .....@.#  $ ###
#   ###.#  #.#  $ $  ##
#     #. #  .# $ $ $  #
#   # #.  ## #$ $ $   #
##  # #.   # $ $ $ ####
 ###  #.   #  $ $ ##
   # #     # $ $  #
   # #    ######$##
   #  ####       #
   ##      #######
    ########