 ######
 #    #####
 # $ *#   #
 #  * * $ #
###* . *  #
# * .@. * #
#  * . *###
# $ * *  #
#   #* $ #
#####    #
    ######