    ####
    #  ######
    #  $ $  ###    ####
    #   $     #   ##  #
#####*#*#$$$  #  ## $ #
#     $ $   $ # ##    #
#  #$    $ $##### $$ ##
## # ####  .....#   ##
#      # $  **.## ###
#   #  # $$ #.##.   #
##     #    #.#+* # #
 #     ######.##..$ #
 ####### # $..##.####
         # # *..*.#
         #   .#.  #
         ######$# #
              #   #
              #####