        #####
        #   #
       ## $ ##
     ### $.$ ###
     #  $.*.$  #
   ### $ *.* $ ###
   #  $ *.*.* $  #
  ## $ *.* *.* $ ##
### $ *.*.$.*.* $ ###
#  $.*.*.$ $.*.*.$  #
# $.*.* $   $ *.*.$ #
#  $.*.*.$ $.*.*.$  #
### $ *.*.$.*.* $ ###
  ## $ *.* *.* $ ##
   #  $ *.*.* $  #
   ### $ *.* $ ###
     #  $.*.$  #
     ### $.$ ###
       ## $ ##
        # @ #
        #####