###### #######
#    ## ######
#.$$. ## #####
# .$$. ## ####
## .$$. ## ###
 ## .$$. ## ##
# ## .$$. ## #
## ## .$$. ##
### ## .$$. ##
#### ## .$$. #
##### ## .$$.#
###### ## @  #
####### ######