                     #
                ### # # ###
               #   # * #   #
               # #  .$.  # #
               #  $.$.$.$  #
            #   # .$.$.$. #   #
       ### # # # .$.$@$.$. # # # ###
      #   #   # .$.$ $ $.$. #   #   #
      # #  .$.   .$.$ $.$.   .$.  # #
      #  $.$.$. # .$.$.$. # .$.$.$  #
       # .$ $.$#  $.$.$.$  #$.$ $. #
      # .$ $ $.# #  .$.  # #.$ $ $. #
     #  $.$ $. #   # * #   # .$ $.$  #
      # .$.$.$  ### # # ###  $.$.$. #
       # .$.  #  #   #   #  #  .$. #
  ### #   ###  $  #     #  $  ###   # ###
 #   # . #   #  . #  *  # .  #   # . #   #
 # #  .$.  # ##   # * * #   ## #  .$.  # #
 #  $.$.$.$  # ### *   * ### #  $.$.$.$  #
  # .$.$.$. #     * ### *     # .$.$.$. #
 # .$.$ $.$. #   * # * # *   # .$.$ $.$. #
# *$.$ $ $.$* # *  #* *#  * # *$.$ $ $.$* #
 # .$.$ $.$. #   * # * # *   # .$.$ $.$. #
  # .$.$.$. #     * ### *     # .$.$.$. #
 #  $.$.$.$  # ### *   * ### #  $.$.$.$  #
 # #  .$.  # ##   # * * #   ## #  .$.  # #
 #   # . #   #  . #  *  # .  #   # . #   #
  ### #   ###  $  #     #  $  ###   # ###
       # .$.  #  #   #   #  #  .$. #
      # .$.$.$  ### # # ###  $.$.$. #
     #  $.$ $. #   # * #   # .$ $.$  #
      # .$ $ $.# #  .$.  # #.$ $ $. #
       # .$ $.$#  $.$.$.$  #$.$ $. #
      #  $.$.$. # .$.$.$. # .$.$.$  #
      # #  .$.   .$.$ $.$.   .$.  # #
      #   #   # .$.$ $ $.$. #   #   #
       ### # # # .$.$ $.$. # # # ###
            #   # .$.$.$. #   #
               #  $.$.$.$  #
               # #  .$.  # #
               #   # * #   #
                ### # # ###
                     #