## ######  ##### ##
####  ######  #####
 #  $.$     $.$  #
## #.. #####.. # ##
##$ $ $.$ $ $ $.$ #
# .. # ..@.. # .. #
# $.$ $ $ $.$ $ $##
## # ..#   # ..# ##
 # #$.$ .$. $.$# ##
 # #    $#$    # #
## #$.$ .$. $.$# #
## #.. #   #.. # ##
##$ $ $.$ $ $ $.$ #
# .. # .. .. # .. #
# $.$ $ $ $.$ $ $##
## # ..##### ..# ##
 #  $.$     $.$  #
#####  ######  ####
## #####  ###### ##