  ####
  #  #
  #$ #
###  ###
#   $$ #
#  ... ###
## $* $$ #
###$.... ###
  # .$* $$ #
  ###$.... #####
    # .$* $$ $ #
    ###$....  @#
      # .$.$#  #
      ###$. ####
        #  $#
        #   #
        #####