              ####
           ####  ## ###
        ####  $   # #*# ####
 ########  $   $  # ### #  #
 #  $ $ $   $ ##  #     #  ##
## $     $ #### $ #######   #
#   $$ ##### $   ##      #  #
#  ## ##  $   $  #          #
#.#  $ # $ $  ####  ## ##   #
#.#  $ $ $ ####        #    #
#.#.#   $  #           #    #
#.#.  ###  #     ########   #
#.#.###@#### ##  #         ##
#.............   # ######  #
#  .########### ## #    ####
#####         #    #
              ######