              ####
 ####       ###  #
 #  #########  ..#
 #  $ @ $   $ #..#
 # $# $   # # #..#
 #  ##*##$#$#$#..#
 # $ #..#.      ##
 #   #*. .##$## #
##$ $#..#.      #
#    ##$#########
#   $$ $ #
##       #
 #########