 #############
 #     @     #
 #**.*****.**#
 #  $     $  #
 #   # ###   #
 #####   #####
######## ######
#             #
#**.*******.**#
#  $       $  #
#   #######   #
#####     #####