         #
        # #
   ### # . # ###
  #   #     #   #
  # $  .$.$.  $ #
  #  $.$.$.$.$  #
   # .$.$.$.$. #
  # .$.$.$.$.$. #
 #  $.$.$ $.$.$  #
# . .$.$ @ $.$. . #
 #  $.$.$ $.$.$  #
  # .$.$.$.$.$. #
   # .$.$.$.$. #
  #  $.$.$.$.$  #
  # $  .$.$.  $ #
  #   #     #   #
   ### # . # ###
        # #
         #