  #######
 ## ##  ##
#####  $###
# $ ..  # #
#   *$*.###
## .$@$. ##
###.*$*   #
# #  .. $ #
###$  #####
 ##  ## ##
  #######