   #####
   ##  #  ####
 ###   ####  #
 #  .*$ #    ###
 #  *.$ #  *. ##
 ##   # ## .*  #
  #  ## ###$$  #
  #####@     ###
###      #####
#  $$### ##  #
#  *. ## #   ##
## .*  # $.*  #
###    # $*.  #
  #  ####   ###
  ####  #  ##
        #####