      #####
      #   #####
    ###$ $#   #
 ####..   #$ $#
 # $ ..##..   ##
 #   # $ ..##..#
 # $ #$#$# $ ..###
####.. $  $#$# $ #
# $ ..# @  $ #   #
#   # $    #.. $ #
# $ #$#$  $ ..####
###.. $ #$#$# $ #
  #..##.. $ #   #
  ##   ..##.. $ #
   #$ $#   ..####
   #   #$ $###
   #####   #
       #####