#####
##  #
## $##
#  @ #
# . *#####
### * $  #
  #  . * #
  ### #  #
    #   ##
    ######