 ###############
##  ....#      ##
#  # #     ###  #
#   ....# #   # #
#      # $ $  # #
##     # $@$ #  #
 ####### $ $ #  #
  ##*#   $ $  # #
   ### ####   # #
    ##     ###  #
     #####     ##
         #######