     #####
     # @ #
     # $ #
     # $ #
    ## $ ##
#####.*.*.#####
#    *. .*    #
# $$$. # .$$$ #
#    *. .*    #
#####.*.*.#####
    ## $ ##
     # $ #
     # $ #
     #   #
     #####