######
#    #######
# ## $ $ $ #
#  . # # # #
###..$  @  #
  #..# #####
  ## #$#
   #   #
   #####