    ####
 ####  ##
 #  # *###
##.$#  * ##
#   @ * * ##
#   #  * * ##
##### * * * #
    ## * *  #
    ##  * * #
     ##  * ##
      ##   #
       ##  #
        ####