      #####
      # . #
  ##### . #####
  #   $ . $   #
  # $ ##.## $ #
  #   # $ #   #
###$##     ##$###
#   #  ***  #   #
#....$ *@* $....#
#   #  ***  #   #
###$##     ##$###
  #   # $ #   #
  # $ ##.## $ #
  #   $ . $   #
  ##### . #####
      # . #
      #####