          #
         # #
        #   #
       # $.  #
      #  * *  #
     #  * * *  #
    #  * * * *  #
   #  * * * * *  #
  #  * * * * * *  #
 #  * * * * * * *$ #
#  . * * *@* * * .  #
 # $* * * * * * *  #
  #  * * * * * *  #
   #  * * * * *  #
    #  * * * *  #
     #  * * *  #
      #  * *  #
       #  .$ #
        #   #
         # #
          #