 ####
 #@ #####
 #  $ $ #
## #*.. ##
#  .   ###
# $$..$$ #
###   .  #
###$..$###
#  .   ###
# $$..$$ #
###   .  #
## ..*# ##
 # $ $  #
 #####  #
     ####