     #######
     #  @  #
###### ### ######
#   #   $   #   #
#   $   #   $   #
##$###*###*###$##
#   $   #   $   #
#   #   *   #   #
##$###*###*###$##
#   #   $   #   #
# ..*...#...*.. #
###### ### ######
     #     #
     #######