'MS46 v2'##############################
#        .........           #
# $      ###### ##         @ #
#######   # $    #############
      ##  #   $  #
       ##$## ###$#
     ####    ..# ##### #####
     #  ..*.**.# #   # #   ##
     # ######.. $  # ###$  ##
     # #    #*. # $        #
     # # #  #  # $$ # ## ###
     #  $ # ##    #####   #
     ##  $   ###### #     #
      # ### ###       $#  #
      #   $   #$ $ ##  ####
      #### $ $    ######
         #  ####  #
         ####  ####