#############################
#   #   #   #   #   #   #   #
# # #   #   #   #   #   # # #
#   .$*$.$*$.$*$.$*$.$*$.   #
###.# # # # # # # # # # #.###
#  $  . . . . . . . . .  $  #
#  *# #$#$#$#$#$#$#$#$# #*  #
#  $  * . . . . . . . *  $  #
###*..$ #$#$#$@$#$#$# $..*###
#  $  * . . . . . . . *  $  #
#  *# #$#$#$#$#$#$#$#$# #*  #
#  $  . . . . . . . . .  $  #
###.# # # # # # # # # # #.###
#   .$*$.$*$.$*$.$*$.$*$.   #
# # #   #   #   #   #   # # #
#   #   #   #   #   #   #   #
#############################