 
    #####
    #   #
    #   ####
   ## *$.$ #
  ## *$.$  #
  # .$.$. ##
 ## .  .@##
## .$.$. #
#  $.$* ##
# $.$* ##
####   #
   #   #
   #####