  #########
  #   #   #
###$. # .$###
# $.$.$.$.$ #
# .$ * * $. #
#  .*   *.  #
###$# @ #$###
#  .*   *.  #
# .$ * * $. #
# $.$.$.$.$ #
###$. # .$###
  #   #   #
  #########