  ########
  #      #
### ## # ####
#  *.** .*  #
#  $   $# @ #
#######   ###
      #####