 ########
##      ##
#  *..*  #
# #$  $#@#
#  ****  #
##     ###
 ###  ##
   ####