             ####
   ##### #####  ##
  ##   ###       ##
 ##   * * . $ # @ ##
 #  ## * ## ### #  #
 # ## *  #  # $  # #
 # # *  #  #     # #
## #   ## # # ###  #
#  ## # #. $ .##  ##
# #.# ## ## #.#  ##
# #  $  #. $ .$ ##
#   #*  $.#  . ##
##### ## ## # ##
    # # $  #  #
    # #    # ##
    #  #$##  #
    ##      ##
     ########