 ###############
## $.       .$ ##
#  # ####### #  #
# #           # #
#  .***$#$***.  #
###     #     ###
  # ####@#### #
  #           #
  #############