           ####
           #  ##
           #  ###
          ##$   #
       ##### $# #
  ######  #   # #
 ##    #    $   #
### ## # ##$ $####
#   $  $  # #    #
#  $  $ # #   #  #
#####  $  ##### ###
 #  ##$#####  $  #####
##  .....#  @# $  $  #
#   ..... .#  $  $   #
# # .....# #### ## ###
#    ##### # ##    ##
#          #  ######
#########  #
        ####