       #####
       #  ##
      ##$  ##
  ##### .$. #
### . . $.$.#
## .$.$.$$. #
#  $.$*  *$.##
# $.$$ ## .  ###
###  . ## $$.$ #
  ##.$*  *$.$  #
   # .$$.$.$. ##
   #.$.$@. . ###
   # .$. #####
   ##  $##
    ##  #
    #####