        #########
        #  * *  #
        #   .   #
       ### # # ###
       # $ # # $ #
       # $ # # $ #
       #  ## ##  #
   ##### ##   ## #####
####      #.$.#      ####
#  #$$ #  . $ .  # $$#  #
#     ###.*.#.*.###     #
#* #### . .$ $. . #### *#
# .     $$# @ #$$     . #
#* #### . .$ $. . #### *#
#     ###.*.#.*.###     #
#  #$$ #  . $ .  # $$#  #
####      #.$.#      ####
   ##### ##   ## #####
       #  ## ##  #
       # $ # # $ #
       # $ # # $ #
       ### # # ###
        #   .   #
        #  * *  #
        #########