 #########################
##       #       #       ##
# $.$.$.$.$.$.$.$.$.$.$.$ #
# .$.$.$. .$.$.$. .$.$.$. #
# $.$ $.$.$.$ $.$.$.$ $.$ #
# .$ $ $. .$ $ $. .$ $ $. #
# $.$ $.$.$.$ $.$.$.$ $.$ #
# .$.$.$. .$.$.$. .$.$.$. #
# $.$.$.$.$.$.$.$.$.$.$.$ #
##. . . .#. .$. .#. . . .##
# $.$.$.$.$.$.$.$.$.$.$.$ #
# .$.$.$. .$.$.$. .$.$.$. #
# $.$ $.$.$.$ $.$.$.$ $.$ #
# .$ $ $.$.$ @ $.$.$ $ $. #
# $.$ $.$.$.$ $.$.$.$ $.$ #
# .$.$.$. .$.$.$. .$.$.$. #
# $.$.$.$.$.$.$.$.$.$.$.$ #
##. . . .#. .$. .#. . . .##
# $.$.$.$.$.$.$.$.$.$.$.$ #
# .$.$.$. .$.$.$. .$.$.$. #
# $.$ $.$.$.$ $.$.$.$ $.$ #
# .$ $ $. .$ $ $. .$ $ $. #
# $.$ $.$.$.$ $.$.$.$ $.$ #
# .$.$.$. .$.$.$. .$.$.$. #
# $.$.$.$.$.$.$.$.$.$.$.$ #
##       #       #       ##
 #########################