             ###
          ###   ###
        ##  $$ $$  ##
      ## $$.#...#.$$ ##
     # $ #..$$ $$..# $ #
    #  #.*$  $ $  $*.#  #
   #  ..$  .#...#.  $..  #
   #$#. .#.*$$ $$*.#. .#$#
  #  .$. .$   $   $. .$.  #
  #$#* #.. $.#.#.$ ..# *#$#
 # $.$ .$ #.$   $.# $. $.$ #
 # .. .* $.  # #  .$ *. .. #
 #$#$ #$ .$ * * * $. $# $#$#
# $.$$.$ # # * * # # $.$$.$ #
#  .  . $.  * @ *  .$ .  .  #
# $.$$.$ # # * * # # $.$$.$ #
 #$#$ #$ .$ * * * $. $# $#$#
 # .. .* $.  # #  .$ *. .. #
 # $.$ .$ #.$   $.# $. $.$ #
  #$#* #.. $.#.#.$ ..# *#$#
  #  .$. .$   $   $. .$.  #
   #$#. .#.*$$ $$*.#. .#$#
   #  ..$  .#...#.  $..  #
    #  #.*$  $ $  $*.#  #
     # $ #..$$ $$..# $ #
      ## $$.#...#.$$ ##
        ##  $$ $$  ##
          ###   ###
             ###