   #######
 ###     ##
 #  *..*  #
 # #$  $#@#
 #  *$$*  #
##  ... ###
#  $#   #
# ** ####
#    #
######