  #############
 ## .   .   . ##
## $.$ $.$ $.$ ##
# $ * $ * $ * $ #
#..*.*.*.*.*.*..#
# $ * $ * $ * $ #
#  $.$.$.$.$.$  #
# $ * $ * $ * $ #
#..*.*.*@*.*.*..#
# $ * $ * $ * $ #
#  $.$.$.$.$.$  #
# $ * $ * $ * $ #
#..*.*.*.*.*.*..#
# $ * $ * $ * $ #
## $.$ $.$ $.$ ##
 ## .   .   . ##
  #############