   #####
   #   #####
   #.$$#   ######
 ###     $ #    #
 #  .## ####### #
 # . . . #    # #
## ###$$$#$$$ ######
 # ..  . .. . #    #
 #  ####### ### ##@#
 ## # $.$.$ # $ $  #
  # #     . #     ###
  # # ## #.######  #
  # .  # $      $  #
  #    ###.## ###$##
  ###### #        #
         ##########