    ## ##
  ##  #  ##
 #  .$ $.  #
 #  *   *  #
# .* #.# *. #
# $ # $ # $ #
 #  .$@$.  #
# $ # $ # $ #
# .* #.# *. #
 #  *   *  #
 #  .$ $.  #
  ##  #  ##
    ## ##