#####################################
#                                   #
# # # # # # # # # # # # # # # # # # #
#  $.$.$.$.$.$.$.$.$.$.$.$.$.$.$.$  #
# #.$.$.$.$.$.$.$.$.$.$.$.$.$.$.$.# #
#  $.$.$.$.$.$.$.$.$.$.$.$.$.$.$.$  #
# #.$.$.$.$.$.$.$.$.$.$.$.$.$.$.$.# #
#  $.$.$.$.$.$.$.$.$.$.$.$.$.$.$.$  #
# #.$.$.$.$.$.$.$.$.$.$.$.$.$.$.$.# #
#  $.$.$.$.$.$.$.$.$.$.$.$.$.$.$.$  #
# #.$.$.$.$.$.$.$.$.$.$.$.$.$.$.$.# #
#  $.$.$.$.$.$.$.$.$.$.$.$.$.$.$.$  #
# #.$.$.$.$.$.$.$.$.$.$.$.$.$.$.$.# #
#  $.$.$.$.$.$.$.$.$.$.$.$.$.$.$.$  #
# #.$.$.$.$.$.$.$.$.$.$.$.$.$.$.$.# #
#  $.$.$.$.$.$.$.$.$.$.$.$.$.$.$.$  #
# #.$.$.$.$.$.$.$.$.$.$.$.$.$.$.$.# #
#  $.$.$.$.$.$.$.$.$.$.$.$.$.$.$.$  #
# #.$.$.$.$.$.$.$.@.$.$.$.$.$.$.$.# #
#  $.$.$.$.$.$.$.$.$.$.$.$.$.$.$.$  #
# #.$.$.$.$.$.$.$.$.$.$.$.$.$.$.$.# #
#  $.$.$.$.$.$.$.$.$.$.$.$.$.$.$.$  #
# #.$.$.$.$.$.$.$.$.$.$.$.$.$.$.$.# #
#  $.$.$.$.$.$.$.$.$.$.$.$.$.$.$.$  #
# #.$.$.$.$.$.$.$.$.$.$.$.$.$.$.$.# #
#  $.$.$.$.$.$.$.$.$.$.$.$.$.$.$.$  #
# #.$.$.$.$.$.$.$.$.$.$.$.$.$.$.$.# #
#  $.$.$.$.$.$.$.$.$.$.$.$.$.$.$.$  #
# #.$.$.$.$.$.$.$.$.$.$.$.$.$.$.$.# #
#  $.$.$.$.$.$.$.$.$.$.$.$.$.$.$.$  #
# #.$.$.$.$.$.$.$.$.$.$.$.$.$.$.$.# #
#  $.$.$.$.$.$.$.$.$.$.$.$.$.$.$.$  #
# #.$.$.$.$.$.$.$.$.$.$.$.$.$.$.$.# #
#  $.$.$.$.$.$.$.$.$.$.$.$.$.$.$.$  #
# # # # # # # # # # # # # # # # # # #
#                                   #
#####################################